tool	parameters	description	errors_05	errors_10	errors_15	errors_20	total_errors
FMLRC2	-k 21 59 -m 5 -f 0.1	defaults	1494	765	253	2	2514
FMLRC2	-k 21 59 80 -m 0 -f 0.1	eukaryote mode	18	18	5	4	45
FMLRC2	-k 20 61 76 -m 3 -f 0.0	random	3431	552	25	4	4012
FMLRC2	-k 19 79 -m 0 -f 0.1	mutated	18	18	5	4	45
FMLRC2	-k 87 -m 17 -f 0.04	random	135	467	75	535	1212
FMLRC2	-k 81 -m 0 -f 0.1	mutated	18	18	18	18	72
FMLRC2	-k 63 84 93 -m 32 -f 0.0	random	18	705	501	742	1966
FMLRC2	-k 21 77 -m 1 -f 0.1	mutated	1028	69	7	2	1106
FMLRC2	-k 30 59 91 -m 4 -f 0.95	random	420	393	144	286	1243
FMLRC2	-k 75 -m 13 -f 0.57	random	248	645	498	194	1585
FMLRC2	-k 20 79 -m 0 -f 0.07	mutated	18	18	18	4	58
FMLRC2	-k 24 33 -m 17 -f 0.33	random	394	533	841	455	2223
FMLRC2	-k 19 80 -m 0 -f 0.1	mutated	18	18	5	4	45
FMLRC2	-k 9 23 34 -m 12 -f 0.58	random	31374	28144	19576	10196	89290
FMLRC2	-k 60 -m 33 -f 0.14	random	18	705	85	94	902
FMLRC2	-k 80 -m 0 -f 0.05	random	18	18	18	18	72
FMLRC2	-k 36 58 96 -m 2 -f 0.01	random	203	23	3	0	229
FMLRC2	-k 19 -m 1 -f 0.08	mutated	2139	81	5	4	2229
FMLRC2	-k 35 -m 3 -f 0.03	random	204	18	4	1	227
FMLRC2	-k 19 81 -m 0 -f 0.1	mutated	18	18	5	4	45
FMLRC2	-k 23 86 -m 31 -f 0.5	random	189	404	696	971	2260
FMLRC2	-k 19 70 81 -m 0 -f 0.1	mutated	18	18	5	4	45
FMLRC2	-k 24 50 -m 0 -f 0.75	random	609	240	322	319	1490
FMLRC2	-k 69 81 -m 0 -f 0.1	mutated	18	18	18	18	72
FMLRC2	-k 33 -m 7 -f 0.08	random	247	299	43	13	602
FMLRC2	-k 17 72 81 -m 1 -f 0.1	mutated	5842	235	49	2	6128
FMLRC2	-k 18 71 -m 36 -f 0.06	random	194	259	713	1169	2335
FMLRC2	-k 19 70 82 -m 0 -f 0.14	mutated	18	81	5	0	104
FMLRC2	-k 73 98 -m 17 -f 0.8	random	134	666	101	727	1628
FMLRC2	-k 18 70 83 -m 0 -f 0.1	mutated	18	18	40	5	81
FMLRC2	-k 94 -m 0 -f 0.01	random	18	18	18	18	72
FMLRC2	-k 38 68 99 -m 1 -f 0.0	random	581	52	7	2	642
FMLRC2	-k 19 70 81 -m 1 -f 0.07	mutated	2498	108	8	2	2616
FMLRC2	-k 9 81 -m 0 -f 0.48	random	23215	23366	23744	23816	94141
FMLRC2	-k 19 70 82 -m 0 -f 0.1	mutated	18	18	5	4	45
FMLRC2	-k 12 55 58 -m 3 -f 0.12	random	4309	272	33	12	4626
FMLRC2	-k 25 -m 16 -f 0.15	random	226	182	342	297	1047
FMLRC2	-k 14 34 -m 25 -f 0.01	random	2128	12154	23246	34322	71850
FMLRC2	-k 19 70 82 -m 0 -f 0.18	mutated	18	81	59	0	158
FMLRC2	-k 72 92 -m 10 -f 0.73	random	210	1080	217	83	1590
FMLRC2	-k 19 70 84 -m 0 -f 0.1	mutated	18	18	5	4	45
FMLRC2	-k 11 94 95 -m 4 -f 0.11	random	1501	209	47	44	1801
FMLRC2	-k 19 70 -m 0 -f 0.1	mutated	18	18	5	4	45
FMLRC2	-k 10 -m 2 -f 0.0	random	45	18	18	18	99
FMLRC2	-k 25 79 -m 1 -f 0.09	random	563	35	8	2	608
FMLRC2	-k 19 69 -m 0 -f 0.1	mutated	18	18	5	4	45
FMLRC2	-k 31 -m 32 -f 0.0	random	194	91	252	200	737
FMLRC2	-k 9 75 -m 0 -f 0.87	random	46507	45892	46095	46961	185455
FMLRC2	-k 17 33 66 -m 0 -f 0.03	random	18	18	18	18	72
FMLRC2	-k 19 69 -m 0 -f 0.03	mutated	18	18	18	18	72
FMLRC2	-k 27 -m 0 -f 0.19	random	18	17	2	0	37
FMLRC2	-k 28 -m 1 -f 0.19	mutated	411	17	5	0	433
FMLRC2	-k 99 -m 31 -f 0.37	random	18	18	18	1099	1153
FMLRC2	-k 27 -m 1 -f 0.19	mutated	414	17	2	0	433
FMLRC2	-k 17 55 67 -m 5 -f 0.25	random	34670	14777	2642	212	52301
FMLRC2	-k 49 87 -m 2 -f 0.01	random	135	13	2	0	150
FMLRC2	-k 51 -m 51 -f 0.17	random	18	18	18	471	525
FMLRC2	-k 52 59 -m 62 -f 0.03	random	18	18	18	18	72
FMLRC2	-k 42 -m 51 -f 0.3	random	18	18	469	430	935
FMLRC2	-k 29 -m 0 -f 0.11	mutated	18	18	5	1	42
FMLRC2	-k 69 -m 3 -f 0.11	random	100	54	6	6	166
FMLRC2	-k 13 70 75 -m 20 -f 0.59	random	18180	30864	30279	26022	105345
FMLRC2	-k 13 26 -m 0 -f 0.01	random	18	18	18	18	72
FMLRC2	-k 28 -m 0 -f 0.19	mutated	18	17	5	0	40
FMLRC2	-k 22 -m 6 -f 0.23	random	482	589	165	5	1241
FMLRC2	-k 26 -m 0 -f 0.27	mutated	18	20	2	1	41
FMLRC2	-k 16 -m 12 -f 0.0	random	1803	35565	42530	18956	98854
FMLRC2	-k 26 -m 0 -f 0.19	mutated	18	20	2	0	40
FMLRC2	-k 10 23 55 -m 1 -f 0.02	random	670	30	6	1	707
FMLRC2	-k 10 98 -m 15 -f 0.0	random	4570	1110	191	607	6478
FMLRC2	-k 29 -m 0 -f 0.19	mutated	18	17	5	0	40
FMLRC2	-k 31 56 -m 4 -f 0.0	random	364	185	10	2	561
FMLRC2	-k 13 54 -m 10 -f 0.16	random	42001	27775	9495	2417	81688
FMLRC2	-k 28 -m 48 -f 0.67	random	18	18	131	44	211
FMLRC2	-k 79 85 99 -m 0 -f 0.03	random	18	18	18	18	72
FMLRC2	-k 19 38 85 -m 37 -f 0.0	random	264	875	364	924	2427
FMLRC2	-k 27 -m 0 -f 0.09	mutated	18	18	18	1	55
FMLRC2	-k 16 68 -m 0 -f 0.04	random	18	18	18	18	72
FMLRC2	-k 27 -m 0 -f 0.13	mutated	18	18	5	1	42
FMLRC2	-k 26 35 53 -m 14 -f 0.87	random	478	722	1083	618	2901
FMLRC2	-k 24 47 83 -m 1 -f 0.02	random	695	40	9	1	745
FMLRC2	-k 28 38 52 -m 7 -f 0.58	random	637	543	93	43	1316
FMLRC2	-k 74 -m 5 -f 0.06	random	89	86	59	10	244
FMLRC2	-k 25 -m 1 -f 0.19	mutated	438	20	2	0	460
FMLRC2	-k 30 80 92 -m 0 -f 0.01	random	18	18	18	18	72
FMLRC2	-k 26 63 -m 0 -f 0.19	mutated	18	20	2	0	40
FMLRC2	-k 38 -m 0 -f 0.07	random	18	18	18	18	72
FMLRC2	-k 27 -m 0 -f 0.18	mutated	18	17	5	0	40
FMLRC2	-k 9 45 91 -m 3 -f 0.06	random	244	91	10	1	346
FMLRC2	-k 27 52 79 -m 34 -f 0.02	random	194	673	622	656	2145
FMLRC2	-k 27 -m 0 -f 0.21	mutated	18	17	2	0	37
FMLRC2	-k 11 18 30 -m 19 -f 0.41	random	31685	17580	14612	17427	81304
FMLRC2	-k 65 -m 11 -f 0.03	random	203	604	198	186	1191
FMLRC2	-k 27 41 -m 8 -f 0.05	random	554	728	145	47	1474
FMLRC2	-k 9 65 -m 11 -f 0.98	random	50436	50147	48546	47403	196532
FMLRC2	-k 16 27 -m 1 -f 0.21	mutated	8985	210	189	18	9402
FMLRC2	-k 20 -m 0 -f 0.41	random	1247	426	92	34	1799
FMLRC2	-k 27 -m 0 -f 0.16	mutated	18	17	5	0	40
FMLRC2	-k 10 59 90 -m 30 -f 0.01	random	19846	5145	1806	877	27674
FMLRC2	-k 55 -m 1 -f 0.5	random	310	11	7	5	333
FMLRC2	-k 24 -m 3 -f 0.13	random	453	70	1	1	525
FMLRC2	-k 26 -m 0 -f 0.21	mutated	18	20	2	0	40
FMLRC2	-k 14 38 -m 11 -f 0.12	random	29848	49006	24873	7458	111185
FMLRC2	-k 27 -m 0 -f 0.26	mutated	18	17	2	1	38
FMLRC2	-k 22 26 83 -m 1 -f 0.02	random	826	45	9	1	881
FMLRC2	-k 25 -m 0 -f 0.21	mutated	18	20	2	0	40
FMLRC2	-k 43 81 -m 2 -f 0.47	random	154	8	13	4	179
FMLRC2	-k 27 -m 0 -f 0.17	mutated	18	17	5	0	40
FMLRC2	-k 12 25 -m 32 -f 0.7	random	25784	37639	37090	33795	134308
FMLRC2	-k 81 -m 0 -f 0.49	random	18	33	8	5	64
FMLRC2	-k 32 -m 17 -f 0.32	random	337	157	551	377	1422
FMLRC2	-k 28 -m 0 -f 0.21	mutated	18	17	2	0	37
FMLRC2	-k 49 -m 28 -f 0.11	random	18	136	80	79	313
FMLRC2	-k 30 -m 1 -f 0.21	mutated	396	17	2	0	415
FMLRC2	-k 24 31 78 -m 11 -f 0.28	random	470	1686	777	512	3445
FMLRC2	-k 77 93 -m 43 -f 0.03	random	18	18	18	698	752
FMLRC2	-k 33 52 -m 16 -f 0.0	random	468	878	813	441	2600
FMLRC2	-k 46 95 -m 0 -f 0.01	random	18	18	18	18	72
FMLRC2	-k 26 -m 1 -f 0.21	mutated	433	20	2	0	455
FMLRC2	-k 91 94 -m 10 -f 0.0	random	213	393	129	33	768
FMLRC2	-k 33 48 48 -m 3 -f 0.0	random	462	66	9	1	538
FMLRC2	-k 19 -m 3 -f 0.34	random	6588	1015	330	117	8050
FMLRC2	-k 10 34 -m 35 -f 0.87	random	51200	47802	44752	43026	186780
FMLRC2	-k 30 -m 0 -f 0.25	mutated	18	17	2	1	38
FMLRC2	-k 19 -m 0 -f 0.1	random	18	18	5	4	45
FMLRC2	-k 15 16 17 -m 0 -f 0.0	random	18	18	18	18	72
FMLRC2	-k 28 -m 0 -f 0.11	mutated	18	18	5	1	42
FMLRC2	-k 15 25 99 -m 45 -f 0.13	random	166	831	8095	11478	20570
FMLRC2	-k 30 -m 0 -f 0.21	mutated	18	17	2	0	37
FMLRC2	-k 58 65 78 -m 1 -f 0.07	random	425	47	8	2	482
FMLRC2	-k 29 -m 1 -f 0.27	mutated	404	17	2	1	424
FMLRC2	-k 32 88 -m 29 -f 0.0	random	189	102	665	615	1571
FMLRC2	-k 16 -m 13 -f 0.1	random	1278	26165	46424	25229	99096
FMLRC2	-k 30 -m 0 -f 0.19	mutated	18	17	5	0	40
FMLRC2	-k 76 90 -m 10 -f 0.02	random	210	1067	273	174	1724
FMLRC2	-k 13 -m 6 -f 0.77	random	44196	27597	20224	15838	107855
FMLRC2	-k 32 -m 0 -f 0.29	mutated	18	15	1	1	35
FMLRC2	-k 12 22 35 -m 52 -f 0.3	random	15948	34045	40635	35567	126195
FMLRC2	-k 35 -m 1 -f 0.01	random	387	15	5	1	408
FMLRC2	-k 39 49 -m 10 -f 0.08	random	220	460	358	169	1207
FMLRC2	-k 11 44 73 -m 0 -f 0.75	random	4369	4042	2494	3045	13950
FMLRC2	-k 32 41 -m 0 -f 0.29	mutated	18	15	1	2	36
FMLRC2	-k 26 78 80 -m 25 -f 0.11	random	192	1317	368	499	2376
FMLRC2	-k 32 -m 0 -f 0.3	mutated	18	15	0	1	34
FMLRC2	-k 15 -m 8 -f 0.0	random	49120	44724	13077	2671	109592
FMLRC2	-k 16 82 -m 5 -f 0.0	random	61037	16198	2648	293	80176
FMLRC2	-k 33 -m 1 -f 0.3	mutated	386	15	0	1	402
FMLRC2	-k 24 53 -m 1 -f 0.07	random	587	26	6	1	620
FMLRC2	-k 26 -m 2 -f 0.4	random	150	18	4	2	174
FMLRC2	-k 35 51 -m 55 -f 0.02	random	18	18	323	555	914
FMLRC2	-k 41 -m 0 -f 0.84	random	109	148	55	139	451
FMLRC2	-k 32 -m 1 -f 0.23	mutated	389	15	1	0	405
FMLRC2	-k 90 -m 39 -f 0.38	random	18	18	18	18	72
FMLRC2	-k 26 91 94 -m 0 -f 0.19	random	18	20	2	0	40
FMLRC2	-k 16 52 90 -m 2 -f 0.2	random	19554	1043	151	23	20771
FMLRC2	-k 30 -m 0 -f 0.3	mutated	18	8	0	2	28
FMLRC2	-k 43 46 -m 5 -f 0.28	random	409	219	15	4	647
FMLRC2	-k 57 86 -m 14 -f 0.23	random	308	366	776	372	1822
FMLRC2	-k 12 -m 5 -f 0.59	random	21012	12417	9725	10302	53456
FMLRC2	-k 88 -m 0 -f 0.33	random	18	18	13	8	57
FMLRC2	-k 34 -m 62 -f 0.18	random	18	18	18	335	389
FMLRC2	-k 16 30 -m 0 -f 0.3	mutated	6204	1344	598	166	8312
FMLRC2	-k 46 81 -m 23 -f 0.15	random	189	790	250	109	1338
FMLRC2	-k 31 -m 0 -f 0.26	mutated	18	16	2	1	37
FMLRC2	-k 16 27 -m 10 -f 0.0	random	7195	68801	45382	13528	134906
FMLRC2	-k 28 -m 0 -f 0.3	mutated	18	6	0	2	26
FMLRC2	-k 13 99 -m 10 -f 0.91	random	32745	34987	29412	25456	122600
FMLRC2	-k 29 -m 0 -f 0.35	mutated	404	7	0	2	413
FMLRC2	-k 11 61 74 -m 11 -f 0.64	random	34866	26604	19393	15964	96827
FMLRC2	-k 10 22 22 -m 10 -f 0.34	random	12277	8760	5059	2064	28160
FMLRC2	-k 26 32 52 -m 48 -f 0.0	random	18	18	641	481	1158
FMLRC2	-k 28 67 -m 0 -f 0.3	mutated	18	33	2	2	55
FMLRC2	-k 18 49 -m 14 -f 0.15	random	395	2215	9596	11416	23622
FMLRC2	-k 28 -m 0 -f 0.28	mutated	18	17	2	1	38
FMLRC2	-k 22 41 65 -m 1 -f 0.06	random	795	39	6	1	841
FMLRC2	-k 27 -m 17 -f 0.67	random	256	229	441	311	1237
FMLRC2	-k 28 -m 0 -f 0.32	mutated	18	6	0	2	26
FMLRC2	-k 9 -m 1 -f 0.48	random	23215	23366	23744	23816	94141
FMLRC2	-k 25 89 -m 61 -f 0.67	random	18	18	195	186	417
FMLRC2	-k 28 70 -m 0 -f 0.32	mutated	18	34	2	2	56
FMLRC2	-k 22 58 67 -m 0 -f 0.97	random	1230	720	832	568	3350
FMLRC2	-k 11 59 65 -m 18 -f 0.06	random	29317	7838	2801	2227	42183
FMLRC2	-k 28 88 -m 0 -f 0.32	mutated	18	6	6	2	32
FMLRC2	-k 16 17 68 -m 10 -f 0.62	random	8831	84383	50744	14829	158787
FMLRC2	-k 28 -m 1 -f 0.32	mutated	411	6	0	2	419
FMLRC2	-k 25 61 89 -m 13 -f 0.47	random	478	859	946	516	2799
FMLRC2	-k 13 41 92 -m 63 -f 0.31	random	4527	6875	14566	22201	48169
FMLRC2	-k 14 16 -m 0 -f 0.72	random	41677	33255	34225	34147	143304
FMLRC2	-k 30 -m 0 -f 0.32	mutated	18	8	0	2	28
FMLRC2	-k 21 31 56 -m 50 -f 0.92	random	18	18	538	488	1062
FMLRC2	-k 27 -m 0 -f 0.38	mutated	414	6	4	2	426
FMLRC2	-k 25 55 93 -m 4 -f 0.78	random	680	382	354	323	1739
FMLRC2	-k 16 -m 21 -f 0.6	random	210	1849	10566	34239	46864
FMLRC2	-k 27 -m 0 -f 0.32	mutated	18	6	1	1	26
FMLRC2	-k 58 -m 0 -f 0.1	random	18	18	18	18	72
FMLRC2	-k 27 -m 0 -f 0.41	mutated	414	6	4	2	426
FMLRC2	-k 14 15 -m 5 -f 0.03	random	106142	19337	2762	335	128576
FMLRC2	-k 34 59 -m 47 -f 0.01	random	18	18	707	515	1258
FMLRC2	-k 25 79 -m 0 -f 0.32	mutated	18	18	5	1	42
FMLRC2	-k 24 33 82 -m 1 -f 0.23	random	660	42	6	1	709
FMLRC2	-k 28 68 90 -m 15 -f 0.84	random	314	336	737	783	2170
FMLRC2	-k 48 -m 24 -f 0.04	random	189	218	77	34	518
FMLRC2	-k 10 65 77 -m 29 -f 0.0	random	18861	4743	1607	472	25683
FMLRC2	-k 12 -m 44 -f 0.14	random	19713	36358	36752	30834	123657
FMLRC2	-k 55 85 -m 0 -f 0.55	random	310	35	8	5	358
FMLRC2	-k 27 -m 0 -f 0.24	mutated	18	17	2	1	38
FMLRC2	-k 49 52 -m 4 -f 0.07	random	313	192	13	4	522
FMLRC2	-k 29 -m 0 -f 0.32	mutated	18	7	0	2	27
FMLRC2	-k 10 59 71 -m 0 -f 0.05	random	45	22	19	23	109
FMLRC2	-k 52 71 89 -m 13 -f 0.31	random	401	1083	492	491	2467
FMLRC2	-k 84 92 -m 13 -f 0.03	random	180	225	124	347	876
FMLRC2	-k 22 30 94 -m 0 -f 0.1	random	18	18	5	1	42
FMLRC2	-k 18 29 55 -m 45 -f 0.27	random	18	94	690	632	1434
FMLRC2	-k 57 69 -m 6 -f 0.08	random	144	296	85	11	536
FMLRC2	-k 10 61 80 -m 25 -f 0.06	random	14253	3743	776	898	19670
FMLRC2	-k 67 -m 4 -f 0.0	random	93	105	23	8	229
FMLRC2	-k 27 -m 0 -f 0.4	mutated	414	6	4	2	426
FMLRC2	-k 93 -m 15 -f 0.13	random	135	615	87	343	1180
FMLRC2	-k 27 78 -m 0 -f 0.32	mutated	18	6	5	1	30
FMLRC2	-k 65 95 -m 14 -f 0.06	random	221	810	1837	227	3095
FMLRC2	-k 27 -m 0 -f 0.35	mutated	414	6	1	1	422
FMLRC2	-k 96 -m 0 -f 0.99	random	18	39	11	12	80
FMLRC2	-k 25 -m 0 -f 0.32	mutated	18	18	1	1	38
FMLRC2	-k 66 -m 56 -f 0.99	random	18	18	18	18	72
FMLRC2	-k 11 14 80 -m 1 -f 0.13	random	3929	184	39	11	4163
FMLRC2	-k 21 70 -m 0 -f 0.05	random	18	18	18	18	72
FMLRC2	-k 18 19 43 -m 6 -f 0.77	random	11386	16946	17286	14366	59984
FMLRC2	-k 29 67 -m 1 -f 0.22	mutated	529	33	2	0	564
FMLRC2	-k 38 -m 0 -f 0.04	random	18	18	18	18	72
FMLRC2	-k 33 46 -m 5 -f 0.24	random	436	235	6	0	677
FMLRC2	-k 27 -m 1 -f 0.32	mutated	414	6	1	1	422
FMLRC2	-k 28 -m 1 -f 0.07	random	411	17	5	1	434
FMLRC2	-k 26 43 -m 0 -f 0.32	mutated	18	31	1	2	52
FMLRC2	-k 86 95 -m 27 -f 0.2	random	18	18	652	542	1230
FMLRC2	-k 29 -m 0 -f 0.39	mutated	404	7	0	2	413
FMLRC2	-k 15 -m 0 -f 0.06	random	18	18	18	12	66
FMLRC2	-k 29 70 -m 15 -f 0.03	random	311	324	470	439	1544
FMLRC2	-k 27 -m 0 -f 0.36	mutated	414	6	1	2	423
FMLRC2	-k 36 51 -m 9 -f 0.32	random	349	424	228	147	1148
FMLRC2	-k 20 24 50 -m 47 -f 0.79	random	18	26	659	536	1239
FMLRC2	-k 96 -m 60 -f 0.2	random	18	18	18	18	72
FMLRC2	-k 15 49 72 -m 23 -f 0.93	random	207	3269	8974	23448	35898
FMLRC2	-k 15 34 48 -m 23 -f 0.05	random	540	8567	17611	39406	66124
FMLRC2	-k 20 33 68 -m 6 -f 0.14	random	2182	3219	707	92	6200
FMLRC2	-k 27 85 -m 0 -f 0.32	mutated	18	6	7	1	32
FMLRC2	-k 42 69 -m 8 -f 0.01	random	364	522	255	116	1257
FMLRC2	-k 93 -m 0 -f 0.65	random	18	40	10	8	76
FMLRC2	-k 29 -m 44 -f 0.99	random	18	18	451	423	910
FMLRC2	-k 9 26 27 -m 30 -f 0.0	random	2847	685	592	624	4748
FMLRC2	-k 27 -m 1 -f 0.41	mutated	414	6	4	2	426
FMLRC2	-k 24 -m 13 -f 0.0	random	184	452	540	274	1450
FMLRC2	-k 26 -m 0 -f 0.32	mutated	18	18	1	1	38
FMLRC2	-k 18 26 72 -m 2 -f 0.76	random	24239	13563	14421	11669	63892
FMLRC2	-k 14 36 -m 1 -f 0.35	random	3835	1469	471	286	6061
FMLRC2	-k 80 93 -m 8 -f 0.08	random	168	611	238	120	1137
FMLRC2	-k 18 63 80 -m 2 -f 0.1	random	10192	491	105	0	10788
FMLRC2	-k 27 -m 0 -f 0.23	mutated	18	17	2	1	38
FMLRC2	-k 19 -m 6 -f 0.6	random	3375	4797	2228	1516	11916
FMLRC2	-k 21 41 57 -m 1 -f 0.03	random	1173	88	6	1	1268
FMLRC2	-k 27 97 -m 0 -f 0.38	mutated	414	6	6	2	428
FMLRC2	-k 14 53 92 -m 56 -f 0.01	random	7761	1036	4939	8307	22043
FMLRC2	-k 24 68 -m 1 -f 0.06	random	606	39	6	1	652
FMLRC2	-k 13 54 56 -m 1 -f 0.04	random	2054	81	9	1	2145
FMLRC2	-k 41 90 90 -m 7 -f 0.06	random	385	938	193	110	1626
FMLRC2	-k 12 33 66 -m 22 -f 0.04	random	37152	31144	17269	11725	97290
FMLRC2	-k 27 47 -m 0 -f 0.32	mutated	18	19	2	2	41
FMLRC2	-k 36 69 -m 4 -f 0.14	random	339	177	19	1	536
FMLRC2	-k 11 29 41 -m 11 -f 0.23	random	13306	2888	1857	1168	19219
FMLRC2	-k 27 -m 0 -f 0.39	mutated	414	6	4	2	426
FMLRC2	-k 15 -m 36 -f 0.01	random	74	2570	3603	7309	13556
FMLRC2	-k 25 -m 45 -f 0.41	random	18	18	212	46	294
FMLRC2	-k 48 -m 23 -f 0.01	random	189	225	105	47	566
FMLRC2	-k 26 -m 1 -f 0.32	mutated	433	18	1	1	453
FMLRC2	-k 45 54 91 -m 53 -f 0.27	random	18	18	18	844	898
FMLRC2	-k 35 61 -m 0 -f 0.0	random	18	18	18	18	72
FMLRC2	-k 27 77 -m 1 -f 0.32	mutated	546	31	4	1	582
FMLRC2	-k 14 68 -m 0 -f 0.0	random	18	18	18	18	72
FMLRC2	-k 24 40 80 -m 3 -f 0.9	random	775	390	339	510	2014
FMLRC2	-k 27 -m 1 -f 0.24	mutated	414	17	2	1	434
FMLRC2	-k 12 38 -m 57 -f 0.01	random	13473	29761	37226	36661	117121
FMLRC2	-k 28 -m 8 -f 0.07	random	422	394	60	22	898
FMLRC2	-k 11 -m 7 -f 0.81	random	34619	28778	26364	26400	116161
FMLRC2	-k 15 85 -m 64 -f 0.02	random	18	3605	895	900	5418
FMLRC2	-k 32 40 40 -m 30 -f 0.06	random	321	224	309	256	1110
FMLRC2	-k 26 99 -m 1 -f 0.39	random	554	48	6	3	611
FMLRC2	-k 14 17 37 -m 7 -f 0.22	random	145024	83457	18059	2808	249348
FMLRC2	-k 22 25 32 -m 7 -f 0.65	random	735	1270	511	348	2864
FMLRC2	-k 50 63 -m 23 -f 0.28	random	194	249	97	45	585
FMLRC2	-k 17 25 -m 36 -f 0.12	random	276	434	719	1288	2717
FMLRC2	-k 27 -m 0 -f 0.29	mutated	18	6	1	1	26
FMLRC2	-k 42 70 70 -m 12 -f 0.12	random	465	896	484	172	2017
FMLRC2	-k 25 -m 0 -f 0.29	mutated	18	18	1	1	38
FMLRC2	-k 13 36 38 -m 0 -f 0.06	random	18	18	21	17	74
FMLRC2	-k 44 -m 6 -f 0.7	random	420	207	59	24	710
FMLRC2	-k 27 -m 0 -f 0.28	mutated	18	17	1	1	37
FMLRC2	-k 51 -m 12 -f 0.33	random	178	292	252	144	866
FMLRC2	-k 21 -m 6 -f 0.33	random	677	946	260	9	1892
FMLRC2	-k 28 -m 0 -f 0.29	mutated	18	6	2	2	28
FMLRC2	-k 9 18 19 -m 5 -f 0.27	random	22265	11712	2630	370	36977
FMLRC2	-k 11 81 98 -m 55 -f 0.15	random	42612	41722	30702	20357	135393
FMLRC2	-k 27 -m 1 -f 0.29	mutated	414	6	1	1	422
FMLRC2	-k 38 -m 5 -f 0.0	random	259	148	8	1	416
FMLRC2	-k 29 58 60 -m 56 -f 0.32	random	18	18	19	424	479
FMLRC2	-k 15 26 38 -m 0 -f 0.59	random	16526	11110	10846	9595	48077
FMLRC2	-k 20 -m 56 -f 0.47	random	18	18	259	124	419
FMLRC2	-k 27 94 -m 0 -f 0.29	mutated	18	6	1	2	27
FMLRC2	-k 77 82 -m 0 -f 0.01	random	18	18	18	18	72
FMLRC2	-k 65 91 -m 6 -f 0.02	random	364	337	97	58	856
FMLRC2	-k 14 41 -m 15 -f 0.48	random	11021	38235	43723	24769	117748
FMLRC2	-k 35 39 66 -m 43 -f 0.0	random	18	18	717	575	1328
FMLRC2	-k 16 75 -m 53 -f 0.0	random	18	155	112	786	1071
FMLRC2	-k 9 -m 56 -f 0.26	random	14387	10629	9521	9163	43700
FMLRC2	-k 43 -m 0 -f 0.02	random	18	18	18	18	72
FMLRC2	-k 26 -m 0 -f 0.29	mutated	18	18	1	1	38
FMLRC2	-k 28 89 -m 18 -f 0.09	random	326	753	562	317	1958
FMLRC2	-k 28 -m 0 -f 0.23	mutated	18	17	2	1	38
FMLRC2	-k 14 23 56 -m 29 -f 0.06	random	2329	9501	25066	26578	63474
FMLRC2	-k 72 80 -m 53 -f 0.39	random	18	18	18	18	72
FMLRC2	-k 13 65 86 -m 0 -f 0.22	random	1725	273	45	11	2054
FMLRC2	-k 46 52 92 -m 1 -f 0.0	random	511	44	8	1	564
FMLRC2	-k 15 -m 0 -f 0.11	random	18	18	49	12	97
FMLRC2	-k 48 -m 4 -f 0.05	random	243	133	8	4	388
FMLRC2	-k 25 39 -m 8 -f 0.11	random	556	790	374	48	1768
FMLRC2	-k 10 22 40 -m 0 -f 0.15	random	760	50	14	1	825
FMLRC2	-k 31 58 63 -m 6 -f 0.02	random	460	538	92	29	1119
FMLRC2	-k 72 -m 0 -f 0.34	random	18	38	7	5	68
FMLRC2	-k 27 -m 0 -f 0.27	mutated	18	17	2	1	38
FMLRC2	-k 60 67 -m 34 -f 0.35	random	18	712	121	132	983
FMLRC2	-k 26 -m 0 -f 0.2	mutated	18	20	2	0	40
FMLRC2	-k 32 -m 13 -f 0.09	random	304	261	240	155	960
FMLRC2	-k 44 77 79 -m 2 -f 0.03	random	214	9	2	0	225
FMLRC2	-k 22 -m 57 -f 0.0	random	18	18	175	69	280
FMLRC2	-k 34 69 99 -m 8 -f 0.0	random	344	505	240	126	1215
FMLRC2	-k 27 53 71 -m 54 -f 0.07	random	18	18	461	139	636
FMLRC2	-k 14 20 -m 5 -f 0.14	random	99094	19024	2335	226	120679
FMLRC2	-k 9 30 -m 63 -f 0.81	random	53105	48718	46674	46460	194957
FMLRC2	-k 33 42 -m 36 -f 0.0	random	18	687	251	138	1094
FMLRC2	-k 29 -m 0 -f 0.29	mutated	18	7	2	2	29
FMLRC2	-k 13 85 -m 40 -f 0.15	random	4269	17320	26060	28265	75914
FMLRC2	-k 38 -m 11 -f 0.0	random	251	135	203	102	691
FMLRC2	-k 23 26 -m 0 -f 0.29	mutated	519	26	12	2	559
FMLRC2	-k 13 51 61 -m 0 -f 0.17	random	1725	69	15	1	1810
FMLRC2	-k 11 17 -m 49 -f 0.44	random	44019	39619	30854	25673	140165
FMLRC2	-k 28 -m 0 -f 0.36	mutated	411	6	0	2	419
FMLRC2	-k 40 -m 10 -f 0.78	random	206	309	222	96	833
FMLRC2	-k 19 70 -m 61 -f 0.11	random	18	35	254	67	374
FMLRC2	-k 28 84 -m 1 -f 0.24	random	543	35	8	1	587
FMLRC2	-k 28 -m 0 -f 0.33	mutated	18	6	0	2	26
FMLRC2	-k 10 12 -m 1 -f 0.2	random	2251	2157	1999	1988	8395
FMLRC2	-k 70 73 88 -m 18 -f 0.81	random	135	673	126	856	1790
FMLRC2	-k 28 49 72 -m 49 -f 0.04	random	18	18	585	469	1090
FMLRC2	-k 30 -m 0 -f 0.33	mutated	18	8	0	2	28
FMLRC2	-k 42 44 66 -m 61 -f 0.15	random	18	18	18	818	872
FMLRC2	-k 14 15 -m 28 -f 0.02	random	3376	12782	30085	48503	94746
FMLRC2	-k 13 21 36 -m 4 -f 0.0	random	33908	3756	349	30	38043
FMLRC2	-k 28 -m 0 -f 0.26	mutated	18	17	2	1	38
FMLRC2	-k 31 90 -m 5 -f 0.08	random	285	287	12	7	591
FMLRC2	-k 29 -m 0 -f 0.33	mutated	18	7	0	2	27
FMLRC2	-k 25 55 -m 41 -f 0.05	random	18	137	555	598	1308
FMLRC2	-k 73 86 -m 17 -f 0.01	random	190	505	98	652	1445
FMLRC2	-k 47 -m 2 -f 0.0	random	98	6	1	0	105
FMLRC2	-k 29 70 -m 1 -f 0.0	random	525	34	6	1	566
FMLRC2	-k 26 -m 0 -f 0.33	mutated	18	18	1	1	38
FMLRC2	-k 27 -m 35 -f 0.0	random	194	95	174	127	590
FMLRC2	-k 30 64 -m 0 -f 0.33	mutated	18	35	2	2	57
FMLRC2	-k 33 41 93 -m 0 -f 0.58	random	460	61	10	14	545
FMLRC2	-k 47 -m 19 -f 0.01	random	188	284	406	467	1345
FMLRC2	-k 28 -m 1 -f 0.33	mutated	411	6	0	2	419
FMLRC2	-k 38 79 -m 5 -f 0.85	random	300	237	117	136	790
FMLRC2	-k 27 -m 1 -f 0.33	mutated	414	6	1	1	422
FMLRC2	-k 10 21 25 -m 45 -f 0.8	random	51680	47819	44723	41770	185992
FMLRC2	-k 44 56 72 -m 3 -f 0.94	random	335	251	153	231	970
FMLRC2	-k 29 39 -m 29 -f 0.76	random	18	137	223	205	583
FMLRC2	-k 28 -m 0 -f 0.42	mutated	411	6	4	2	423
FMLRC2	-k 9 36 49 -m 13 -f 0.29	random	10886	10042	8592	5915	35435
FMLRC2	-k 48 52 99 -m 28 -f 0.0	random	18	195	125	585	923
FMLRC2	-k 21 -m 0 -f 0.62	random	811	557	260	263	1891
FMLRC2	-k 41 43 67 -m 0 -f 0.49	random	435	33	17	4	489
FMLRC2	-k 82 85 -m 51 -f 0.35	random	18	18	18	18	72
FMLRC2	-k 90 -m 39 -f 0.01	random	18	18	18	18	72
FMLRC2	-k 28 -m 0 -f 0.4	mutated	411	6	4	2	423
FMLRC2	-k 65 -m 1 -f 0.7	random	276	11	9	8	304
FMLRC2	-k 88 -m 7 -f 0.08	random	673	473	117	72	1335
FMLRC2	-k 13 28 59 -m 0 -f 0.0	random	18	18	18	18	72
FMLRC2	-k 16 39 83 -m 0 -f 0.27	random	6204	645	241	85	7175
FMLRC2	-k 42 -m 2 -f 0.2	random	108	5	1	0	114
FMLRC2	-k 29 -m 0 -f 0.37	mutated	404	7	0	2	413
FMLRC2	-k 75 -m 58 -f 0.0	random	18	18	18	18	72
FMLRC2	-k 11 28 -m 0 -f 0.33	mutated	3474	335	181	86	4076
FMLRC2	-k 11 27 36 -m 19 -f 0.01	random	31698	9229	3871	1930	46728
FMLRC2	-k 15 -m 33 -f 0.33	random	105	1715	5190	9641	16651
FMLRC2	-k 97 -m 41 -f 0.48	random	18	18	18	18	72
FMLRC2	-k 16 23 -m 6 -f 0.12	random	81834	44927	8579	1205	136545
FMLRC2	-k 95 -m 9 -f 0.18	random	139	529	51	28	747
FMLRC2	-k 99 -m 7 -f 0.03	random	123	336	67	39	565
FMLRC2	-k 51 -m 50 -f 0.0	random	18	18	473	471	980
FMLRC2	-k 21 -m 8 -f 0.76	random	427	1261	667	865	3220
FMLRC2	-k 11 60 64 -m 2 -f 0.13	random	435	129	32	15	611
FMLRC2	-k 37 66 -m 8 -f 0.65	random	555	495	236	168	1454
FMLRC2	-k 28 -m 0 -f 0.37	mutated	411	6	0	2	419
FMLRC2	-k 36 -m 36 -f 0.79	random	18	138	208	54	418
FMLRC2	-k 71 -m 16 -f 0.65	random	134	84	70	331	619
FMLRC2	-k 12 38 -m 51 -f 0.43	random	16143	32826	38159	35004	122132
FMLRC2	-k 74 -m 5 -f 0.36	random	89	86	59	10	244
FMLRC2	-k 34 66 81 -m 7 -f 0.0	random	711	570	149	52	1482
FMLRC2	-k 67 80 93 -m 15 -f 0.11	random	213	738	400	541	1892
FMLRC2	-k 28 -m 0 -f 0.31	mutated	18	6	0	2	26
FMLRC2	-k 24 28 -m 32 -f 0.0	random	276	396	402	398	1472
FMLRC2	-k 12 18 58 -m 7 -f 0.0	random	28852	18215	5846	933	53846
FMLRC2	-k 27 -m 0 -f 0.31	mutated	18	6	1	1	26
FMLRC2	-k 15 -m 39 -f 0.03	random	74	1040	2377	6282	9773
FMLRC2	-k 27 -m 1 -f 0.31	mutated	414	6	1	1	422
FMLRC2	-k 28 -m 63 -f 0.59	random	18	18	18	29	83
FMLRC2	-k 27 68 -m 0 -f 0.31	mutated	18	34	3	1	56
FMLRC2	-k 28 78 -m 52 -f 0.06	random	18	18	337	140	513
FMLRC2	-k 26 -m 0 -f 0.37	mutated	433	18	4	2	457
FMLRC2	-k 21 74 83 -m 45 -f 0.0	random	18	21	181	657	877
FMLRC2	-k 70 77 -m 0 -f 0.25	random	18	37	7	3	65
FMLRC2	-k 29 -m 0 -f 0.31	mutated	18	7	0	2	27
FMLRC2	-k 37 -m 2 -f 0.94	random	147	148	65	129	489
FMLRC2	-k 26 -m 0 -f 0.31	mutated	18	18	1	1	38
FMLRC2	-k 39 -m 14 -f 0.82	random	348	98	288	373	1107
FMLRC2	-k 55 57 59 -m 16 -f 0.26	random	305	382	1259	415	2361
FMLRC2	-k 25 -m 1 -f 0.31	mutated	438	18	1	1	458
FMLRC2	-k 56 65 -m 53 -f 0.85	random	18	18	18	19	73
FMLRC2	-k 26 29 99 -m 44 -f 0.05	random	18	458	288	56	820
FMLRC2	-k 33 36 -m 0 -f 0.03	random	18	18	18	18	72
FMLRC2	-k 87 -m 25 -f 0.0	random	18	18	440	86	562
FMLRC2	-k 27 40 -m 0 -f 0.31	mutated	18	18	1	2	39
FMLRC2	-k 10 61 -m 30 -f 0.02	random	19846	5150	1400	462	26858
FMLRC2	-k 65 66 -m 3 -f 0.02	random	150	85	5	6	246
FMLRC2	-k 33 96 -m 39 -f 0.18	random	18	424	168	42	652
FMLRC2	-k 41 -m 3 -f 0.04	random	157	25	4	3	189
FMLRC2	-k 9 -m 4 -f 0.01	random	22	18	18	18	76
FMLRC2	-k 24 -m 1 -f 0.31	mutated	463	18	1	1	483
FMLRC2	-k 36 -m 24 -f 0.55	random	188	204	384	192	968
FMLRC2	-k 38 -m 1 -f 0.0	random	385	14	5	1	405
FMLRC2	-k 15 18 79 -m 0 -f 0.0	random	18	18	18	18	72
FMLRC2	-k 30 52 98 -m 11 -f 0.0	random	443	752	1249	265	2709
FMLRC2	-k 17 29 -m 0 -f 0.01	random	18	18	18	18	72
FMLRC2	-k 9 15 58 -m 0 -f 0.13	random	1303	394	293	4	1994
FMLRC2	-k 12 45 65 -m 0 -f 0.03	random	18	18	18	18	72
FMLRC2	-k 27 39 -m 0 -f 0.31	mutated	18	17	1	2	38
FMLRC2	-k 20 22 -m 1 -f 0.9	random	4129	3424	2553	3204	13310
FMLRC2	-k 25 -m 0 -f 0.31	mutated	18	18	1	1	38
FMLRC2	-k 9 73 -m 22 -f 0.37	random	18455	17112	16157	16117	67841
FMLRC2	-k 9 57 -m 0 -f 0.36	random	14387	807	286	239	15719
FMLRC2	-k 21 27 -m 0 -f 0.31	mutated	843	83	12	2	940
FMLRC2	-k 24 -m 5 -f 0.23	random	519	179	78	2	778
FMLRC2	-k 15 -m 3 -f 0.1	random	34020	3038	349	38	37445
FMLRC2	-k 25 36 71 -m 5 -f 0.11	random	812	341	152	3	1308
FMLRC2	-k 22 72 -m 0 -f 0.05	random	18	18	18	18	72
FMLRC2	-k 15 30 44 -m 36 -f 0.0	random	74	3240	9058	8397	20769
FMLRC2	-k 14 30 84 -m 2 -f 0.2	random	11931	621	52	5	12609
FMLRC2	-k 27 70 -m 0 -f 0.31	mutated	18	34	3	1	56
FMLRC2	-k 32 38 65 -m 28 -f 0.2	random	274	694	325	252	1545
FMLRC2	-k 79 79 -m 5 -f 0.15	random	128	135	40	9	312
FMLRC2	-k 16 42 50 -m 26 -f 0.21	random	266	1276	3430	11464	16436
FMLRC2	-k 28 -m 1 -f 0.31	mutated	411	6	0	2	419
FMLRC2	-k 9 98 -m 1 -f 0.08	random	336	108	65	40	549
FMLRC2	-k 66 81 90 -m 3 -f 0.0	random	174	135	6	5	320
FMLRC2	-k 10 20 -m 0 -f 0.0	random	18	18	18	18	72
FMLRC2	-k 29 -m 1 -f 0.31	mutated	404	7	0	2	413
FMLRC2	-k 59 -m 29 -f 0.14	random	18	621	150	35	824
FMLRC2	-k 18 84 85 -m 43 -f 0.07	random	18	207	217	238	680
FMLRC2	-k 42 58 -m 0 -f 0.0	random	18	18	18	18	72
FMLRC2	-k 45 58 -m 11 -f 0.16	random	474	412	471	221	1578
FMLRC2	-k 27 -m 1 -f 0.36	mutated	414	6	1	2	423
FMLRC2	-k 23 79 -m 0 -f 0.18	random	18	20	5	1	44
FMLRC2	-k 12 56 61 -m 61 -f 0.21	random	11406	27994	36452	37355	113207
FMLRC2	-k 19 45 72 -m 0 -f 0.01	random	18	18	18	18	72
FMLRC2	-k 69 -m 43 -f 0.04	random	18	18	18	473	527
FMLRC2	-k 55 78 -m 39 -f 0.0	random	18	18	496	100	632
FMLRC2	-k 18 45 -m 15 -f 0.3	random	371	1578	8055	12979	22983
FMLRC2	-k 9 -m 30 -f 0.34	random	17285	14929	14077	14044	60335
FMLRC2	-k 27 -m 0 -f 0.25	mutated	18	17	2	1	38
FMLRC2	-k 18 48 63 -m 22 -f 0.09	random	470	573	1306	4333	6682
FMLRC2	-k 49 91 -m 7 -f 0.16	random	384	651	178	65	1278
FMLRC2	-k 26 -m 0 -f 0.35	mutated	433	18	1	1	453
FMLRC2	-k 33 75 -m 5 -f 0.0	random	301	232	25	1	559
FMLRC2	-k 56 -m 9 -f 0.02	random	36	198	165	100	499
FMLRC2	-k 11 13 -m 37 -f 0.72	random	50474	68162	70696	66671	256003
FMLRC2	-k 64 87 -m 0 -f 0.68	random	276	13	8	6	303
FMLRC2	-k 27 -m 0 -f 0.3	mutated	18	6	1	1	26
FMLRC2	-k 11 39 -m 4 -f 0.66	random	19422	7211	5889	5357	37879
FMLRC2	-k 20 61 -m 0 -f 0.62	random	1966	892	539	671	4068
FMLRC2	-k 29 -m 0 -f 0.3	mutated	18	7	0	2	27
FMLRC2	-k 19 40 53 -m 60 -f 0.12	random	18	41	249	527	835
FMLRC2	-k 9 15 18 -m 3 -f 0.0	random	70064	6192	751	73	77080
FMLRC2	-k 31 47 51 -m 38 -f 0.99	random	18	458	693	734	1903
FMLRC2	-k 43 67 86 -m 35 -f 0.22	random	18	137	208	621	984
FMLRC2	-k 27 42 43 -m 30 -f 0.42	random	189	230	285	266	970
FMLRC2	-k 27 -m 1 -f 0.28	mutated	414	17	1	1	433
FMLRC2	-k 24 48 71 -m 16 -f 0.15	random	438	634	888	647	2607
FMLRC2	-k 35 -m 11 -f 0.14	random	242	141	225	104	712
FMLRC2	-k 27 -m 0 -f 0.34	mutated	414	6	1	1	422
FMLRC2	-k 70 -m 5 -f 0.72	random	87	89	40	12	228
FMLRC2	-k 40 75 92 -m 18 -f 0.76	random	186	869	1718	349	3122
FMLRC2	-k 25 76 78 -m 21 -f 0.11	random	364	1196	478	382	2420
FMLRC2	-k 76 -m 1 -f 0.15	random	266	35	7	4	312
FMLRC2	-k 27 -m 1 -f 0.3	mutated	414	6	1	1	422
FMLRC2	-k 12 -m 2 -f 0.21	random	1733	228	143	95	2199
FMLRC2	-k 18 52 -m 0 -f 0.12	random	18	18	40	1	77
FMLRC2	-k 43 -m 4 -f 0.75	random	289	147	25	99	560
FMLRC2	-k 25 -m 0 -f 0.3	mutated	18	18	1	1	38
FMLRC2	-k 36 47 78 -m 4 -f 0.0	random	526	264	15	2	807
FMLRC2	-k 84 -m 49 -f 0.0	random	18	18	18	18	72
FMLRC2	-k 39 64 -m 2 -f 0.08	random	194	6	3	0	203
FMLRC2	-k 27 46 -m 0 -f 0.34	mutated	534	18	2	2	556
FMLRC2	-k 64 77 -m 55 -f 0.15	random	18	18	18	18	72
FMLRC2	-k 11 41 53 -m 18 -f 0.02	random	29317	8125	3439	1729	42610
FMLRC2	-k 74 -m 0 -f 0.28	random	18	18	7	3	46
FMLRC2	-k 17 20 39 -m 27 -f 0.12	random	538	662	1380	4053	6633
FMLRC2	-k 46 -m 6 -f 0.0	random	417	212	26	16	671
FMLRC2	-k 15 39 60 -m 14 -f 0.01	random	4960	36704	52456	30092	124212
FMLRC2	-k 11 47 91 -m 12 -f 0.33	random	15798	6389	4460	3003	29650
FMLRC2	-k 49 -m 8 -f 0.02	random	211	259	83	13	566
FMLRC2	-k 26 -m 0 -f 0.3	mutated	18	18	1	1	38
FMLRC2	-k 23 57 -m 0 -f 0.2	random	18	30	5	0	53
FMLRC2	-k 17 21 66 -m 58 -f 0.0	random	18	193	324	82	617
FMLRC2	-k 12 81 -m 24 -f 0.98	random	22279	35876	38172	36663	132990
FMLRC2	-k 50 51 70 -m 2 -f 0.01	random	219	12	2	0	233
FMLRC2	-k 45 -m 27 -f 0.19	random	18	98	162	100	378
FMLRC2	-k 67 85 -m 0 -f 0.0	random	18	18	18	18	72
FMLRC2	-k 22 26 98 -m 10 -f 0.65	random	608	783	1088	507	2986
FMLRC2	-k 24 27 -m 0 -f 0.3	mutated	18	26	1	2	47
FMLRC2	-k 9 67 93 -m 0 -f 0.03	random	24	21	18	21	84
FMLRC2	-k 29 -m 1 -f 0.3	mutated	404	7	0	2	413
FMLRC2	-k 30 66 -m 13 -f 0.36	random	476	497	631	235	1839
FMLRC2	-k 94 -m 1 -f 0.8	random	208	20	11	17	256
FMLRC2	-k 61 68 -m 0 -f 0.02	random	18	18	18	18	72
FMLRC2	-k 26 -m 0 -f 0.01	random	18	18	18	18	72
FMLRC2	-k 16 -m 0 -f 0.08	random	18	18	18	11	65
FMLRC2	-k 27 -m 1 -f 0.22	mutated	414	17	2	1	434
FMLRC2	-k 10 -m 0 -f 0.08	random	148	99	77	110	434
FMLRC2	-k 9 44 45 -m 2 -f 0.08	random	244	25	5	0	274
FMLRC2	-k 14 44 -m 24 -f 0.28	random	2489	12923	24783	36696	76891
FMLRC2	-k 16 -m 0 -f 0.12	random	18	18	45	11	92
FMLRC2	-k 92 -m 11 -f 0.1	random	192	145	172	29	538
FMLRC2	-k 30 60 63 -m 0 -f 0.19	random	18	17	6	0	41
FMLRC2	-k 48 69 99 -m 3 -f 0.0	random	297	128	9	3	437
FMLRC2	-k 14 99 -m 31 -f 0.0	random	1460	7525	15034	22887	46906
FMLRC2	-k 63 83 -m 37 -f 0.21	random	18	18	416	654	1106
FMLRC2	-k 29 61 -m 0 -f 0.18	random	18	17	6	0	41
FMLRC2	-k 45 46 89 -m 8 -f 0.04	random	383	831	308	73	1595
FMLRC2	-k 10 -m 1 -f 0.0	random	25	18	18	18	79
FMLRC2	-k 14 21 25 -m 52 -f 0.0	random	906	1172	18568	23217	43863
FMLRC2	-k 23 30 84 -m 7 -f 0.09	random	958	1148	430	51	2587
FMLRC2	-k 83 -m 15 -f 0.01	random	130	86	70	134	420
FMLRC2	-k 82 -m 38 -f 0.1	random	18	18	18	468	522
FMLRC2	-k 36 39 81 -m 42 -f 0.33	random	18	18	324	132	492
FMLRC2	-k 16 54 -m 4 -f 0.06	random	56382	8888	1091	153	66514
FMLRC2	-k 19 38 -m 1 -f 0.22	random	2848	93	50	1	2992
FMLRC2	-k 27 -m 0 -f 0.33	mutated	18	6	1	1	26
FMLRC2	-k 19 59 -m 0 -f 0.01	random	18	18	18	18	72
FMLRC2	-k 10 18 40 -m 0 -f 0.16	random	1058	149	51	1	1259
FMLRC2	-k 27 34 -m 55 -f 0.65	random	18	18	501	713	1250
FMLRC2	-k 27 -m 1 -f 0.26	mutated	414	17	2	1	434
FMLRC2	-k 26 54 76 -m 46 -f 0.79	random	18	18	590	454	1080
FMLRC2	-k 18 78 -m 52 -f 0.8	random	18	400	217	64	699
FMLRC2	-k 27 55 70 -m 40 -f 0.21	random	18	137	604	566	1325
FMLRC2	-k 20 61 -m 0 -f 0.0	random	18	18	18	18	72
FMLRC2	-k 48 -m 61 -f 0.93	random	18	18	18	18	72
FMLRC2	-k 20 31 35 -m 13 -f 0.25	random	401	1265	2631	3685	7982
FMLRC2	-k 9 -m 1 -f 0.15	random	2081	2019	2153	2160	8413
FMLRC2	-k 27 66 88 -m 0 -f 0.03	random	18	18	18	18	72
FMLRC2	-k 31 -m 0 -f 0.04	random	18	18	18	18	72
FMLRC2	-k 23 40 51 -m 8 -f 0.0	random	719	1046	628	176	2569
FMLRC2	-k 58 61 -m 4 -f 0.06	random	187	141	8	7	343
FMLRC2	-k 26 93 -m 1 -f 0.4	random	561	47	8	2	618
FMLRC2	-k 13 30 44 -m 57 -f 0.06	random	3931	8537	17191	28683	58342
FMLRC2	-k 74 -m 6 -f 0.0	random	110	162	46	13	331
FMLRC2	-k 52 77 82 -m 0 -f 0.55	random	328	45	13	5	391
FMLRC2	-k 15 63 78 -m 42 -f 0.0	random	195	843	2478	5901	9417
FMLRC2	-k 11 28 85 -m 2 -f 0.05	random	483	15	3	0	501
FMLRC2	-k 22 58 73 -m 0 -f 0.35	random	570	53	9	2	634
FMLRC2	-k 15 23 28 -m 0 -f 0.25	random	9159	696	438	127	10420
FMLRC2	-k 52 80 -m 0 -f 0.02	random	18	18	18	18	72
FMLRC2	-k 27 30 -m 0 -f 0.33	mutated	18	8	1	2	29
FMLRC2	-k 10 -m 0 -f 0.03	random	25	18	19	18	80
FMLRC2	-k 30 63 90 -m 1 -f 0.46	random	622	60	8	6	696
FMLRC2	-k 15 44 50 -m 24 -f 0.12	random	479	4988	14099	33144	52710
FMLRC2	-k 10 39 61 -m 4 -f 0.01	random	539	183	6	1	729
FMLRC2	-k 73 -m 2 -f 0.0	random	124	12	7	5	148
FMLRC2	-k 16 -m 64 -f 0.31	random	18	186	92	3301	3597
FMLRC2	-k 40 -m 3 -f 0.29	random	157	25	4	3	189
FMLRC2	-k 23 27 51 -m 31 -f 0.0	random	273	542	434	747	1996
FMLRC2	-k 20 45 56 -m 43 -f 0.05	random	18	24	588	708	1338
FMLRC2	-k 20 55 -m 64 -f 0.09	random	18	18	173	78	287
FMLRC2	-k 12 45 67 -m 50 -f 0.44	random	16419	33269	38136	34351	122175
FMLRC2	-k 45 74 -m 0 -f 0.77	random	366	42	19	10	437
FMLRC2	-k 66 -m 41 -f 0.0	random	18	18	465	468	969
FMLRC2	-k 25 78 95 -m 13 -f 0.13	random	364	604	563	301	1832
FMLRC2	-k 27 95 -m 1 -f 0.41	mutated	536	36	8	2	582
FMLRC2	-k 97 -m 8 -f 0.0	random	134	26	87	35	282
FMLRC2	-k 13 82 -m 39 -f 0.0	random	4617	17790	26430	29184	78021
FMLRC2	-k 10 20 -m 24 -f 0.01	random	13299	2548	1066	980	17893
FMLRC2	-k 18 -m 46 -f 0.32	random	18	84	210	221	533
FMLRC2	-k 19 28 65 -m 11 -f 0.04	random	663	3953	7705	5433	17754
FMLRC2	-k 11 -m 0 -f 0.43	random	6645	6832	6735	6165	26377
FMLRC2	-k 32 38 -m 2 -f 0.02	random	180	7	1	0	188
FMLRC2	-k 29 40 -m 39 -f 0.0	random	18	712	383	63	1176
FMLRC2	-k 85 86 87 -m 0 -f 0.0	random	18	18	18	18	72
FMLRC2	-k 11 12 84 -m 0 -f 0.31	random	4505	3861	532	287	9185
FMLRC2	-k 11 42 79 -m 45 -f 0.04	random	44648	37368	23651	13395	119062
FMLRC2	-k 88 -m 59 -f 0.0	random	18	18	18	18	72
FMLRC2	-k 19 61 -m 17 -f 0.55	random	363	562	1629	4887	7441
FMLRC2	-k 42 -m 3 -f 0.53	random	145	25	11	11	192
FMLRC2	-k 25 37 44 -m 5 -f 0.11	random	832	332	126	4	1294
FMLRC2	-k 19 23 89 -m 2 -f 0.04	random	6452	590	90	0	7132
FMLRC2	-k 9 85 -m 48 -f 0.32	random	18808	14686	13371	13137	60002
FMLRC2	-k 69 75 93 -m 40 -f 0.65	random	18	18	461	672	1169
FMLRC2	-k 27 -m 0 -f 0.04	random	18	18	18	18	72
FMLRC2	-k 13 44 -m 0 -f 0.0	random	18	18	18	18	72
FMLRC2	-k 20 50 -m 12 -f 0.04	random	321	1211	2230	2120	5882
FMLRC2	-k 35 -m 4 -f 0.01	random	258	121	4	1	384
FMLRC2	-k 56 78 -m 0 -f 0.0	random	18	18	18	18	72
FMLRC2	-k 44 74 -m 49 -f 0.19	random	18	18	422	550	1008
FMLRC2	-k 9 56 -m 42 -f 0.0	random	5765	866	621	544	7796
FMLRC2	-k 12 25 -m 0 -f 0.33	mutated	1733	469	221	131	2554
FMLRC2	-k 17 -m 3 -f 0.1	random	28846	2886	385	32	32149
FMLRC2	-k 50 58 76 -m 7 -f 0.22	random	607	339	167	24	1137
FMLRC2	-k 9 72 -m 4 -f 0.6	random	30472	24719	16942	10506	82639
FMLRC2	-k 15 36 38 -m 8 -f 0.04	random	52514	50128	14694	3036	120372
FMLRC2	-k 27 79 -m 0 -f 0.33	mutated	18	6	5	1	30
FMLRC2	-k 48 57 93 -m 0 -f 0.48	random	18	10	5	4	37
FMLRC2	-k 53 -m 0 -f 0.07	random	18	18	18	18	72
FMLRC2	-k 9 -m 0 -f 0.52	random	25771	26136	26408	26878	105193
FMLRC2	-k 45 -m 50 -f 0.02	random	18	18	422	428	886
FMLRC2	-k 12 76 -m 17 -f 0.0	random	38437	22929	12185	6406	79957
FMLRC2	-k 36 97 -m 1 -f 0.01	random	495	39	7	2	543
FMLRC2	-k 25 -m 0 -f 0.33	mutated	18	18	1	1	38
FMLRC2	-k 40 51 -m 4 -f 0.0	random	408	189	10	3	610
FMLRC2	-k 41 64 96 -m 54 -f 0.0	random	18	18	479	429	944
FMLRC2	-k 89 93 96 -m 17 -f 0.0	random	135	1118	128	830	2211
FMLRC2	-k 27 71 -m 0 -f 0.33	mutated	18	34	3	1	56
FMLRC2	-k 89 -m 60 -f 0.1	random	18	18	18	18	72
FMLRC2	-k 27 -m 0 -f 0.42	mutated	414	6	4	2	426
FMLRC2	-k 36 67 -m 0 -f 0.0	random	18	18	18	18	72
FMLRC2	-k 50 73 -m 1 -f 0.65	random	445	65	16	7	533
FMLRC2	-k 9 32 43 -m 0 -f 0.93	random	48252	2842	3145	5630	59869
FMLRC2	-k 15 87 -m 0 -f 0.02	random	18	18	18	18	72
FMLRC2	-k 9 12 22 -m 32 -f 0.06	random	31769	38797	29893	19205	119664
FMLRC2	-k 21 68 92 -m 10 -f 0.3	random	594	1607	1183	589	3973
FMLRC2	-k 13 26 -m 0 -f 0.33	mutated	1725	630	344	232	2931
FMLRC2	-k 19 66 -m 3 -f 0.01	random	7095	1151	120	4	8370
FMLRC2	-k 74 -m 10 -f 0.0	random	139	858	182	160	1339
FMLRC2	-k 18 27 -m 0 -f 0.33	mutated	3578	649	308	117	4652
FMLRC2	-k 21 60 60 -m 0 -f 0.01	random	18	18	18	18	72
FMLRC2	-k 61 -m 49 -f 0.04	random	18	18	18	18	72
FMLRC2	-k 60 66 -m 40 -f 0.02	random	18	18	642	718	1396
FMLRC2	-k 53 76 -m 0 -f 0.17	random	18	18	5	2	43
FMLRC2	-k 19 -m 47 -f 0.71	random	18	150	211	157	536
FMLRC2	-k 14 15 33 -m 0 -f 0.02	random	18	18	18	18	72
FMLRC2	-k 50 63 92 -m 0 -f 0.0	random	18	18	18	18	72
FMLRC2	-k 29 -m 1 -f 0.33	mutated	404	7	0	2	413
FMLRC2	-k 43 61 -m 2 -f 0.02	random	162	7	3	0	172
FMLRC2	-k 26 27 -m 0 -f 0.39	mutated	517	26	7	3	553
FMLRC2	-k 10 17 71 -m 64 -f 0.06	random	46346	22774	10838	5554	85512
FMLRC2	-k 24 -m 25 -f 0.0	random	270	209	252	408	1139
FMLRC2	-k 27 31 -m 0 -f 0.27	mutated	18	17	2	2	39
FMLRC2	-k 12 20 55 -m 48 -f 0.15	random	17650	34166	47045	33678	132539
FMLRC2	-k 16 -m 12 -f 0.02	random	1803	35565	42530	18956	98854
FMLRC2	-k 46 -m 60 -f 0.02	random	18	18	18	587	641
FMLRC2	-k 25 -m 11 -f 0.0	random	223	484	382	210	1299
FMLRC2	-k 9 85 -m 11 -f 0.08	random	398	381	369	386	1534
FMLRC2	-k 28 66 -m 42 -f 0.03	random	18	18	592	493	1121
FMLRC2	-k 36 -m 14 -f 0.01	random	295	296	238	212	1041
FMLRC2	-k 28 -m 1 -f 0.42	mutated	411	6	4	2	423
FMLRC2	-k 26 -m 17 -f 0.29	random	256	229	411	304	1200
FMLRC2	-k 16 60 95 -m 1 -f 0.04	random	6561	211	42	2	6816
FMLRC2	-k 64 71 -m 28 -f 0.02	random	18	1041	131	97	1287
FMLRC2	-k 22 22 51 -m 0 -f 0.04	random	18	18	18	18	72
FMLRC2	-k 26 51 79 -m 23 -f 0.0	random	357	929	296	574	2156
FMLRC2	-k 28 -m 52 -f 0.97	random	18	18	18	29	83
FMLRC2	-k 32 -m 21 -f 0.29	random	194	219	311	469	1193
FMLRC2	-k 58 -m 9 -f 0.0	random	34	197	203	103	537
FMLRC2	-k 13 52 -m 17 -f 0.57	random	23980	33315	29711	18964	105970
FMLRC2	-k 9 23 43 -m 18 -f 0.58	random	33470	31249	29392	24085	118196
FMLRC2	-k 89 -m 2 -f 0.6	random	49	13	9	8	79
FMLRC2	-k 13 52 -m 13 -f 0.04	random	32835	35403	20482	7519	96239
FMLRC2	-k 16 18 45 -m 61 -f 0.57	random	18	147	213	3992	4370
FMLRC2	-k 91 -m 31 -f 0.29	random	18	18	448	514	998
FMLRC2	-k 59 70 -m 3 -f 0.28	random	185	78	2	5	270
FMLRC2	-k 49 89 -m 32 -f 0.07	random	18	137	554	576	1285
FMLRC2	-k 25 -m 0 -f 0.23	mutated	18	20	2	1	41
FMLRC2	-k 26 49 80 -m 1 -f 0.08	random	662	40	8	2	712
FMLRC2	-k 58 84 93 -m 38 -f 0.72	random	18	18	86	508	630
FMLRC2	-k 15 27 -m 0 -f 0.33	mutated	5504	1046	912	249	7711
FMLRC2	-k 16 60 -m 21 -f 0.6	random	210	1914	10625	34251	47000
FMLRC2	-k 42 86 -m 5 -f 0.31	random	292	280	22	7	601
FMLRC2	-k 15 28 40 -m 2 -f 0.1	random	25368	1096	123	0	26587
FMLRC2	-k 27 -m 0 -f 0.43	mutated	414	17	4	6	441
FMLRC2	-k 27 -m 59 -f 0.0	random	18	18	195	290	521
FMLRC2	-k 68 -m 29 -f 0.04	random	18	660	93	89	860
FMLRC2	-k 45 -m 37 -f 0.5	random	18	632	259	84	993
FMLRC2	-k 42 72 -m 0 -f 0.46	random	345	35	16	4	400
FMLRC2	-k 66 74 -m 22 -f 0.12	random	18	656	115	546	1335
FMLRC2	-k 12 96 -m 0 -f 0.56	random	12010	4529	2624	3512	22675
FMLRC2	-k 61 70 -m 16 -f 0.02	random	244	284	628	415	1571
FMLRC2	-k 15 18 -m 10 -f 0.0	random	29011	113433	58170	16299	216913
FMLRC2	-k 15 41 -m 18 -f 0.0	random	921	13539	40508	48500	103468
FMLRC2	-k 84 -m 0 -f 0.39	random	18	37	13	6	74
FMLRC2	-k 74 91 95 -m 0 -f 0.48	random	18	37	12	5	72
FMLRC2	-k 75 -m 0 -f 0.63	random	272	37	7	9	325
FMLRC2	-k 11 39 91 -m 0 -f 0.03	random	18	19	18	18	73
FMLRC2	-k 9 -m 0 -f 0.6	random	31090	31596	31484	31610	125780
FMLRC2	-k 42 53 74 -m 32 -f 0.85	random	18	686	616	153	1473
FMLRC2	-k 44 61 -m 0 -f 0.15	random	18	18	6	1	43
FMLRC2	-k 24 41 -m 62 -f 0.06	random	18	18	173	661	870
FMLRC2	-k 45 -m 64 -f 0.1	random	18	18	18	18	72
FMLRC2	-k 15 61 70 -m 9 -f 0.01	random	33394	52825	19758	4923	110900
FMLRC2	-k 80 -m 21 -f 0.07	random	18	616	80	572	1286
FMLRC2	-k 42 -m 4 -f 0.01	random	294	123	11	3	431
FMLRC2	-k 46 53 -m 0 -f 0.04	random	18	18	18	18	72
FMLRC2	-k 22 26 -m 0 -f 0.33	mutated	570	33	12	2	617
FMLRC2	-k 38 52 80 -m 9 -f 0.81	random	495	819	415	222	1951
FMLRC2	-k 52 -m 9 -f 0.77	random	43	194	180	134	551
FMLRC2	-k 24 -m 0 -f 0.0	random	18	18	18	18	72
FMLRC2	-k 95 -m 5 -f 0.02	random	246	159	29	23	457
FMLRC2	-k 26 -m 1 -f 0.24	mutated	433	20	2	1	456
FMLRC2	-k 17 54 -m 20 -f 0.34	random	330	961	4526	17196	23013
FMLRC2	-k 23 37 40 -m 6 -f 0.76	random	801	719	463	483	2466
FMLRC2	-k 92 -m 12 -f 0.05	random	127	150	194	87	558
FMLRC2	-k 26 -m 11 -f 0.62	random	460	440	334	159	1393
FMLRC2	-k 17 18 19 -m 0 -f 0.77	random	51029	36765	33867	29241	150902
FMLRC2	-k 9 28 -m 1 -f 0.0	random	411	17	5	1	434
FMLRC2	-k 27 62 -m 1 -f 0.33	mutated	543	28	3	1	575
FMLRC2	-k 86 -m 4 -f 0.0	random	69	87	15	11	182
FMLRC2	-k 14 29 -m 0 -f 0.33	mutated	3549	617	470	265	4901
FMLRC2	-k 34 79 87 -m 14 -f 0.48	random	432	431	384	578	1825
FMLRC2	-k 32 78 -m 4 -f 0.38	random	350	172	7	3	532
FMLRC2	-k 42 60 90 -m 3 -f 0.98	random	247	236	167	208	858
FMLRC2	-k 27 -m 0 -f 0.37	mutated	414	6	4	2	426
FMLRC2	-k 23 25 51 -m 6 -f 0.76	random	845	794	598	569	2806
FMLRC2	-k 23 34 80 -m 4 -f 0.07	random	955	570	101	3	1629
FMLRC2	-k 27 65 -m 0 -f 0.31	mutated	18	33	3	1	55
FMLRC2	-k 58 -m 0 -f 0.63	random	299	11	6	6	322
FMLRC2	-k 19 -m 0 -f 0.0	random	18	18	18	18	72
FMLRC2	-k 61 -m 11 -f 0.0	random	206	330	194	182	912
FMLRC2	-k 29 66 -m 5 -f 0.52	random	594	253	36	33	916
FMLRC2	-k 15 24 -m 1 -f 0.0	random	8653	200	42	1	8896
FMLRC2	-k 26 54 -m 1 -f 0.08	random	558	26	6	1	591
FMLRC2	-k 37 52 -m 0 -f 0.0	random	18	18	18	18	72
FMLRC2	-k 27 78 -m 0 -f 0.33	mutated	18	6	5	1	30
FMLRC2	-k 52 -m 26 -f 0.08	random	18	136	77	36	267
FMLRC2	-k 55 73 99 -m 13 -f 0.08	random	380	1098	1601	332	3411
FMLRC2	-k 15 18 49 -m 52 -f 0.03	random	18	261	8472	5214	13965
FMLRC2	-k 15 40 49 -m 48 -f 0.02	random	18	151	1803	3964	5936
FMLRC2	-k 10 34 -m 8 -f 0.01	random	915	300	65	24	1304
FMLRC2	-k 42 -m 36 -f 0.2	random	18	623	174	77	892
FMLRC2	-k 31 77 -m 5 -f 0.53	random	305	234	24	17	580
FMLRC2	-k 16 -m 0 -f 0.86	random	36787	26473	30047	25229	118536
FMLRC2	-k 25 48 -m 0 -f 0.33	mutated	18	32	2	1	53
FMLRC2	-k 63 -m 24 -f 0.15	random	18	614	81	358	1071
FMLRC2	-k 29 33 91 -m 41 -f 0.05	random	18	458	255	63	794
FMLRC2	-k 46 68 -m 28 -f 0.01	random	18	728	141	165	1052
FMLRC2	-k 30 -m 38 -f 0.0	random	18	221	174	117	530
FMLRC2	-k 71 84 -m 0 -f 0.06	random	18	18	18	18	72
FMLRC2	-k 17 -m 57 -f 0.02	random	18	193	182	85	478
FMLRC2	-k 46 55 72 -m 0 -f 0.0	random	18	18	18	18	72
FMLRC2	-k 66 -m 0 -f 0.02	random	18	18	18	18	72
FMLRC2	-k 17 92 94 -m 17 -f 0.04	random	316	2472	11684	26479	40951
FMLRC2	-k 12 89 -m 0 -f 0.16	random	479	86	82	36	683
FMLRC2	-k 9 24 -m 35 -f 0.01	random	4066	724	416	245	5451
FMLRC2	-k 69 -m 7 -f 0.43	random	343	136	75	19	573
FMLRC2	-k 18 54 -m 2 -f 0.27	random	10660	507	152	29	11348
FMLRC2	-k 24 27 -m 0 -f 0.38	mutated	550	26	39	3	618
FMLRC2	-k 18 24 -m 1 -f 0.06	random	5194	113	40	1	5348
FMLRC2	-k 31 -m 1 -f 0.02	random	393	16	5	1	415
FMLRC2	-k 13 27 47 -m 1 -f 0.0	random	2236	74	9	1	2320
FMLRC2	-k 33 78 -m 14 -f 0.37	random	386	395	407	434	1622
FMLRC2	-k 26 -m 28 -f 0.44	random	189	615	454	278	1536
FMLRC2	-k 29 42 66 -m 48 -f 0.29	random	18	18	649	569	1254
FMLRC2	-k 25 -m 0 -f 0.34	mutated	438	18	1	1	458
FMLRC2	-k 54 73 91 -m 2 -f 0.1	random	185	14	2	1	202
FMLRC2	-k 81 -m 27 -f 0.22	random	18	18	431	87	554
FMLRC2	-k 12 27 -m 0 -f 0.33	mutated	1733	477	234	133	2577
FMLRC2	-k 28 -m 13 -f 0.86	random	205	284	347	243	1079
FMLRC2	-k 51 91 -m 0 -f 0.0	random	18	18	18	18	72
FMLRC2	-k 21 27 -m 0 -f 0.33	mutated	843	83	12	2	940
FMLRC2	-k 92 -m 0 -f 0.15	random	18	18	18	18	72
FMLRC2	-k 97 -m 0 -f 0.12	random	18	18	18	18	72
FMLRC2	-k 82 -m 14 -f 0.0	random	129	155	82	329	695
FMLRC2	-k 12 -m 9 -f 0.27	random	28652	8164	1801	360	38977
FMLRC2	-k 31 62 76 -m 44 -f 0.01	random	18	18	616	494	1146
FMLRC2	-k 60 71 -m 7 -f 0.11	random	517	266	111	20	914
FMLRC2	-k 36 40 83 -m 58 -f 0.05	random	18	18	18	665	719
FMLRC2	-k 11 27 -m 7 -f 0.21	random	5102	1844	660	228	7834
FMLRC2	-k 21 60 82 -m 35 -f 0.05	random	194	965	747	782	2688
FMLRC2	-k 71 79 92 -m 2 -f 0.11	random	160	16	7	5	188
FMLRC2	-k 13 15 -m 59 -f 0.06	random	4571	8593	20312	29607	63083
FMLRC2	-k 16 32 -m 7 -f 0.07	random	45345	51327	12118	2090	110880
FMLRC2	-k 34 37 72 -m 0 -f 0.02	random	18	18	18	18	72
FMLRC2	-k 12 -m 48 -f 0.47	random	17650	34125	37571	33075	122421
FMLRC2	-k 77 -m 26 -f 0.61	random	18	18	92	87	215
FMLRC2	-k 99 -m 6 -f 0.0	random	317	151	36	68	572
FMLRC2	-k 10 24 48 -m 0 -f 0.22	random	2504	87	9	13	2613
FMLRC2	-k 35 53 -m 1 -f 0.39	random	490	23	6	1	520
FMLRC2	-k 18 42 -m 0 -f 0.02	random	18	18	18	18	72
FMLRC2	-k 27 56 -m 0 -f 0.33	mutated	18	26	3	1	48
FMLRC2	-k 26 85 -m 13 -f 0.02	random	303	565	521	212	1601
FMLRC2	-k 49 63 -m 3 -f 0.0	random	195	93	10	3	301
FMLRC2	-k 72 95 -m 52 -f 0.0	random	18	18	18	18	72
FMLRC2	-k 14 -m 21 -f 0.8	random	4129	13928	26940	41005	86002
FMLRC2	-k 50 -m 2 -f 0.21	random	100	10	2	0	112
FMLRC2	-k 15 96 -m 57 -f 0.14	random	18	859	1425	1956	4258
FMLRC2	-k 91 -m 12 -f 0.54	random	127	151	88	87	453
FMLRC2	-k 31 -m 3 -f 0.22	random	262	17	0	1	280
FMLRC2	-k 10 90 -m 3 -f 0.14	random	768	522	313	187	1790
FMLRC2	-k 15 50 62 -m 61 -f 0.64	random	18	3612	1356	1087	6073
FMLRC2	-k 76 89 -m 12 -f 0.06	random	235	717	272	274	1498
FMLRC2	-k 27 57 -m 1 -f 0.3	mutated	544	25	3	1	573
FMLRC2	-k 9 26 61 -m 0 -f 0.87	random	4453	4109	6011	5090	19663
FMLRC2	-k 98 -m 41 -f 0.41	random	18	18	18	18	72
FMLRC2	-k 97 -m 0 -f 0.07	random	18	18	18	18	72
FMLRC2	-k 81 92 -m 0 -f 0.0	random	18	18	18	18	72
FMLRC2	-k 17 61 65 -m 0 -f 0.01	random	18	18	18	18	72
FMLRC2	-k 63 -m 37 -f 0.04	random	18	18	416	420	872
FMLRC2	-k 74 78 82 -m 35 -f 0.02	random	18	18	756	866	1658
FMLRC2	-k 15 -m 7 -f 0.08	random	63216	35115	8036	1265	107632
FMLRC2	-k 25 -m 0 -f 0.37	mutated	438	18	24	2	482
FMLRC2	-k 10 13 63 -m 1 -f 0.01	random	1968	82	10	1	2061
FMLRC2	-k 73 -m 57 -f 0.07	random	18	18	18	18	72
FMLRC2	-k 20 22 -m 0 -f 0.97	random	4129	3424	3055	3265	13873
FMLRC2	-k 12 53 89 -m 44 -f 0.01	random	19713	36358	37149	31237	124457
FMLRC2	-k 44 -m 5 -f 0.41	random	200	152	14	4	370
FMLRC2	-k 17 35 37 -m 0 -f 0.01	random	18	18	18	18	72
FMLRC2	-k 25 56 -m 11 -f 0.27	random	357	879	697	308	2241
FMLRC2	-k 10 23 89 -m 28 -f 0.36	random	24451	16647	14119	13050	68267
FMLRC2	-k 20 -m 1 -f 0.39	random	1247	426	92	44	1809
FMLRC2	-k 74 -m 3 -f 0.46	random	85	62	7	6	160
FMLRC2	-k 9 -m 2 -f 0.06	random	99	88	99	95	381
FMLRC2	-k 30 73 -m 1 -f 0.03	random	521	32	6	1	560
FMLRC2	-k 34 -m 1 -f 0.21	random	388	15	1	0	404
FMLRC2	-k 22 27 47 -m 0 -f 0.28	random	570	29	13	2	614
FMLRC2	-k 59 -m 26 -f 0.01	random	18	615	81	585	1299
FMLRC2	-k 87 90 -m 1 -f 0.0	random	246	45	13	8	312
FMLRC2	-k 48 93 -m 33 -f 0.58	random	18	623	163	1176	1980
FMLRC2	-k 12 39 -m 8 -f 0.31	random	25161	6197	1164	968	33490
FMLRC2	-k 26 -m 19 -f 0.67	random	339	161	524	318	1342
FMLRC2	-k 43 -m 0 -f 0.1	random	18	18	18	1	55
FMLRC2	-k 74 -m 38 -f 0.51	random	18	18	460	468	964
FMLRC2	-k 21 -m 0 -f 0.0	random	18	18	18	18	72
FMLRC2	-k 14 16 44 -m 6 -f 0.07	random	156754	46143	7559	1101	211557
FMLRC2	-k 16 27 -m 0 -f 0.33	mutated	6204	1428	680	349	8661
FMLRC2	-k 39 44 54 -m 24 -f 0.7	random	188	344	296	127	955
FMLRC2	-k 17 27 51 -m 11 -f 0.23	random	1392	25233	45254	18973	90852
FMLRC2	-k 79 -m 6 -f 0.13	random	73	151	53	19	296
FMLRC2	-k 28 37 63 -m 26 -f 0.11	random	272	891	1476	367	3006
FMLRC2	-k 17 42 45 -m 8 -f 0.0	random	7627	36501	17667	3702	65497
FMLRC2	-k 20 27 -m 0 -f 0.34	mutated	1681	133	38	47	1899
FMLRC2	-k 71 77 -m 4 -f 0.16	random	162	158	34	9	363
FMLRC2	-k 21 -m 0 -f 0.5	random	811	293	174	59	1337
FMLRC2	-k 40 44 92 -m 18 -f 0.0	random	267	948	2017	332	3564
FMLRC2	-k 23 37 41 -m 0 -f 0.06	random	18	18	18	18	72
FMLRC2	-k 16 80 85 -m 0 -f 0.27	random	6204	1011	271	35	7521
FMLRC2	-k 33 41 -m 16 -f 0.22	random	474	330	710	428	1942
FMLRC2	-k 9 -m 6 -f 0.41	random	18808	18695	18759	18760	75022
FMLRC2	-k 21 35 47 -m 14 -f 0.6	random	462	1056	1346	1711	4575
FMLRC2	-k 18 -m 11 -f 0.8	random	512	6632	11537	9686	28367
FMLRC2	-k 20 -m 5 -f 0.26	random	2029	1396	264	44	3733
FMLRC2	-k 45 72 -m 7 -f 0.0	random	1214	352	127	23	1716
FMLRC2	-k 31 -m 47 -f 0.23	random	18	18	127	43	206
FMLRC2	-k 73 74 99 -m 4 -f 0.7	random	243	179	42	13	477
FMLRC2	-k 23 59 -m 0 -f 0.01	random	18	18	18	18	72
FMLRC2	-k 14 -m 2 -f 0.0	random	11063	603	62	14	11742
FMLRC2	-k 18 68 -m 0 -f 0.01	random	18	18	18	18	72
FMLRC2	-k 30 51 83 -m 11 -f 0.2	random	447	727	467	285	1926
FMLRC2	-k 9 46 50 -m 5 -f 0.04	random	414	216	25	4	659
FMLRC2	-k 22 32 -m 5 -f 0.25	random	920	704	219	3	1846
FMLRC2	-k 28 32 94 -m 4 -f 0.11	random	440	228	10	6	684
FMLRC2	-k 18 87 90 -m 2 -f 0.31	random	8921	478	199	45	9643
FMLRC2	-k 13 36 72 -m 54 -f 0.38	random	2968	9475	19309	26226	57978
FMLRC2	-k 33 35 80 -m 2 -f 0.23	random	242	9	2	0	253
FMLRC2	-k 66 69 -m 1 -f 0.0	random	332	44	6	3	385
FMLRC2	-k 66 -m 39 -f 0.0	random	18	18	460	456	952
FMLRC2	-k 15 32 48 -m 57 -f 0.39	random	18	859	1886	7943	10706
FMLRC2	-k 28 55 92 -m 8 -f 0.3	random	669	915	186	168	1938
FMLRC2	-k 9 50 55 -m 19 -f 0.47	random	25661	23543	23233	23279	95716
FMLRC2	-k 63 -m 20 -f 0.01	random	188	90	76	227	581
FMLRC2	-k 22 59 -m 25 -f 0.39	random	257	801	309	720	2087
FMLRC2	-k 31 -m 8 -f 0.46	random	311	310	65	22	708
FMLRC2	-k 73 75 -m 2 -f 0.01	random	142	13	7	5	167
FMLRC2	-k 26 -m 0 -f 0.0	random	18	18	18	18	72
FMLRC2	-k 27 99 -m 0 -f 0.33	mutated	18	6	1	2	27
FMLRC2	-k 50 -m 13 -f 0.07	random	168	379	327	209	1083
FMLRC2	-k 78 -m 1 -f 0.0	random	248	33	10	4	295
FMLRC2	-k 84 -m 3 -f 0.87	random	40	71	14	10	135
FMLRC2	-k 10 19 26 -m 5 -f 0.0	random	7311	5425	1218	173	14127
FMLRC2	-k 10 -m 17 -f 0.59	random	35067	29247	26832	26090	117236
FMLRC2	-k 17 21 35 -m 24 -f 0.03	random	478	713	2513	7632	11336
FMLRC2	-k 9 98 -m 2 -f 0.78	random	40794	37419	38134	34644	150991
FMLRC2	-k 54 89 -m 38 -f 0.0	random	18	18	86	97	219
FMLRC2	-k 20 47 91 -m 18 -f 0.03	random	441	1137	2585	1898	6061
FMLRC2	-k 86 -m 0 -f 0.38	random	18	35	13	6	72
FMLRC2	-k 26 28 -m 1 -f 0.33	mutated	522	26	1	2	551
FMLRC2	-k 11 51 72 -m 17 -f 0.01	random	27434	7093	2980	2562	40069
FMLRC2	-k 93 -m 3 -f 0.53	random	38	69	11	8	126
FMLRC2	-k 26 -m 20 -f 0.05	random	369	247	440	369	1425
FMLRC2	-k 85 -m 0 -f 0.08	random	18	18	18	18	72
FMLRC2	-k 33 80 -m 56 -f 0.0	random	18	18	18	609	663
FMLRC2	-k 25 -m 31 -f 0.0	random	189	323	274	277	1063
FMLRC2	-k 23 -m 3 -f 0.19	random	617	110	8	1	736
FMLRC2	-k 97 -m 62 -f 0.96	random	18	18	18	18	72
FMLRC2	-k 10 55 71 -m 17 -f 0.0	random	6446	1014	725	1687	9872
FMLRC2	-k 16 -m 56 -f 0.14	random	18	145	123	573	859
FMLRC2	-k 71 -m 33 -f 0.18	random	18	18	86	87	209
FMLRC2	-k 11 -m 2 -f 0.04	random	286	24	18	18	346
FMLRC2	-k 76 79 -m 8 -f 0.09	random	108	438	303	36	885
FMLRC2	-k 10 19 -m 14 -f 0.73	random	40941	34787	29104	20325	125157
FMLRC2	-k 13 49 -m 25 -f 0.12	random	12900	27857	29243	28308	98308
FMLRC2	-k 23 -m 9 -f 0.23	random	429	579	293	104	1405
FMLRC2	-k 25 78 -m 0 -f 0.13	random	18	18	5	1	42
FMLRC2	-k 33 36 44 -m 13 -f 0.03	random	430	503	444	350	1727
FMLRC2	-k 40 78 -m 16 -f 0.27	random	303	167	444	354	1268
FMLRC2	-k 15 -m 1 -f 0.13	random	5504	187	49	10	5750
FMLRC2	-k 27 -m 1 -f 0.25	mutated	414	17	2	1	434
FMLRC2	-k 27 55 -m 44 -f 0.16	random	18	18	559	448	1043
FMLRC2	-k 11 87 -m 38 -f 0.22	random	46262	32000	16989	8637	103888
FMLRC2	-k 21 38 -m 0 -f 0.34	random	1056	79	16	3	1154
FMLRC2	-k 52 93 -m 9 -f 0.63	random	159	529	215	135	1038
FMLRC2	-k 59 70 -m 41 -f 0.12	random	18	18	650	654	1340
FMLRC2	-k 36 -m 13 -f 0.96	random	299	296	238	322	1155
FMLRC2	-k 26 -m 1 -f 0.33	mutated	433	18	1	1	453
FMLRC2	-k 35 37 88 -m 2 -f 0.01	random	219	9	2	0	230
FMLRC2	-k 14 31 40 -m 1 -f 0.0	random	3949	125	19	1	4094
FMLRC2	-k 33 37 39 -m 20 -f 0.62	random	390	489	860	901	2640
FMLRC2	-k 35 48 64 -m 12 -f 0.0	random	472	702	621	380	2175
FMLRC2	-k 10 16 31 -m 37 -f 0.03	random	27410	10733	3393	3234	44770
FMLRC2	-k 28 32 -m 22 -f 0.43	random	356	307	353	914	1930
FMLRC2	-k 14 20 41 -m 7 -f 0.0	random	100827	55162	11658	1462	169109
FMLRC2	-k 18 -m 0 -f 0.05	random	18	18	18	18	72
FMLRC2	-k 70 -m 14 -f 0.07	random	90	132	492	209	923
FMLRC2	-k 27 -m 1 -f 0.42	mutated	414	6	4	2	426
FMLRC2	-k 10 12 76 -m 13 -f 0.32	random	47763	22912	13169	9190	93034
FMLRC2	-k 26 35 86 -m 40 -f 0.25	random	18	137	616	143	914
FMLRC2	-k 36 82 -m 0 -f 0.01	random	18	18	18	18	72
FMLRC2	-k 27 64 -m 1 -f 0.33	mutated	543	33	3	1	580
FMLRC2	-k 14 30 52 -m 11 -f 0.47	random	30517	51279	26254	7856	115906
FMLRC2	-k 18 33 -m 7 -f 0.27	random	5114	17117	6871	1195	30297
FMLRC2	-k 19 28 65 -m 52 -f 0.01	random	18	39	264	247	568
FMLRC2	-k 94 95 -m 64 -f 0.2	random	18	18	18	18	72
FMLRC2	-k 68 -m 1 -f 0.56	random	277	12	6	7	302
FMLRC2	-k 28 38 47 -m 1 -f 0.89	random	468	410	169	296	1343
FMLRC2	-k 58 -m 1 -f 0.01	random	299	24	6	1	330
FMLRC2	-k 10 12 48 -m 3 -f 0.01	random	4315	263	29	4	4611
FMLRC2	-k 22 34 80 -m 11 -f 0.0	random	447	1662	1141	823	4073
FMLRC2	-k 28 79 -m 3 -f 0.0	random	336	84	0	1	421
FMLRC2	-k 36 45 -m 6 -f 0.3	random	586	363	27	14	990
FMLRC2	-k 54 -m 0 -f 0.31	mutated	18	22	2	3	45
FMLRC2	-k 82 -m 1 -f 0.33	random	239	34	10	4	287
FMLRC2	-k 58 66 -m 3 -f 0.78	random	188	82	13	15	298
FMLRC2	-k 34 34 -m 47 -f 0.0	random	18	18	694	100	830
FMLRC2	-k 25 -m 1 -f 0.33	mutated	438	18	1	1	458
FMLRC2	-k 19 -m 9 -f 0.0	random	643	4916	4453	1516	11528
FMLRC2	-k 36 -m 6 -f 0.1	random	271	220	18	4	513
FMLRC2	-k 20 38 -m 1 -f 0.1	random	1623	64	5	1	1693
FMLRC2	-k 27 36 -m 0 -f 0.33	mutated	18	17	1	2	38
FMLRC2	-k 14 -m 11 -f 0.14	random	29595	48166	24633	7355	109749
FMLRC2	-k 18 -m 43 -f 0.14	random	18	207	217	238	680
FMLRC2	-k 70 -m 60 -f 0.05	random	18	18	18	18	72
FMLRC2	-k 44 -m 3 -f 0.25	random	161	25	4	3	193
FMLRC2	-k 11 80 92 -m 10 -f 0.16	random	10926	2825	656	450	14857
FMLRC2	-k 13 82 -m 0 -f 0.01	random	18	18	18	18	72
FMLRC2	-k 31 -m 13 -f 0.04	random	284	262	240	154	940
FMLRC2	-k 10 33 57 -m 2 -f 0.5	random	6115	1586	1211	938	9850
FMLRC2	-k 9 74 -m 1 -f 0.0	random	273	37	7	3	320
FMLRC2	-k 31 -m 15 -f 0.0	random	299	206	293	346	1144
FMLRC2	-k 87 96 99 -m 19 -f 0.39	random	18	1135	491	1390	3034
FMLRC2	-k 42 88 -m 22 -f 0.27	random	188	796	250	389	1623
FMLRC2	-k 16 28 -m 3 -f 0.69	random	56803	21012	20459	17777	116051
FMLRC2	-k 17 44 69 -m 4 -f 0.39	random	44076	9016	1134	502	54728
FMLRC2	-k 13 23 79 -m 2 -f 0.06	random	6752	314	26	0	7092
FMLRC2	-k 24 80 -m 59 -f 0.01	random	18	18	173	66	275
FMLRC2	-k 66 71 -m 11 -f 0.0	random	271	1255	302	144	1972
FMLRC2	-k 30 -m 0 -f 0.26	random	18	17	2	1	38
FMLRC2	-k 16 50 -m 0 -f 0.24	random	18	184	112	17	331
FMLRC2	-k 63 -m 41 -f 0.07	random	18	18	460	471	967
FMLRC2	-k 49 69 76 -m 11 -f 0.27	random	297	987	443	289	2016
FMLRC2	-k 33 67 -m 0 -f 0.09	random	18	18	18	1	55
FMLRC2	-k 54 -m 1 -f 0.97	random	91	109	44	134	378
FMLRC2	-k 28 -m 0 -f 0.35	mutated	411	6	0	2	419
FMLRC2	-k 20 86 -m 1 -f 0.31	random	1412	103	25	1	1541
FMLRC2	-k 29 63 -m 0 -f 0.33	mutated	18	31	2	2	53
FMLRC2	-k 32 45 53 -m 13 -f 0.71	random	499	637	543	331	2010
FMLRC2	-k 25 -m 2 -f 0.14	random	215	18	2	0	235
FMLRC2	-k 17 27 -m 0 -f 0.33	mutated	5483	1283	478	222	7466
FMLRC2	-k 34 94 -m 0 -f 0.31	random	18	15	0	2	35
FMLRC2	-k 30 -m 1 -f 0.09	random	396	17	5	1	419
FMLRC2	-k 59 76 83 -m 60 -f 0.13	random	18	18	18	18	72
FMLRC2	-k 23 81 -m 55 -f 0.0	random	18	18	175	110	321
FMLRC2	-k 17 -m 0 -f 0.3	random	5483	918	385	123	6909
FMLRC2	-k 30 54 86 -m 0 -f 0.0	random	18	18	18	18	72
FMLRC2	-k 26 46 52 -m 46 -f 0.02	random	18	18	695	764	1495
FMLRC2	-k 19 71 92 -m 1 -f 0.83	random	6074	4424	4401	4664	19563
FMLRC2	-k 36 50 50 -m 0 -f 0.17	random	18	14	6	0	38
FMLRC2	-k 12 76 -m 0 -f 0.07	random	18	22	18	18	76
FMLRC2	-k 24 91 -m 32 -f 0.03	random	189	326	709	795	2019
FMLRC2	-k 15 83 89 -m 1 -f 0.01	random	5684	212	49	3	5948
HyPo	-m 5 -x -4 -g -8 -n 20 -q 2	defaults	58	39	4	4	105
HyPo	-m 10 -x -5 -g 0 -n 22 -q 58	random	inf	inf	inf	inf	inf
HyPo	-m 5 -x -3 -g -7 -n 26 -q 2	mutated	58	39	4	4	105
HyPo	-m 2 -x -10 -g -4 -n 12 -q 17	random	72	46	8	4	130
HyPo	-m 5 -x -3 -g -7 -n 26 -q 1	mutated	58	39	4	4	105
HyPo	-m 10 -x 0 -g 0 -n 20 -q 55	random	inf	inf	inf	inf	inf
HyPo	-m 5 -x -3 -g -7 -n 26 -q 0	mutated	58	41	1	4	104
HyPo	-m 4 -x -10 -g -10 -n 0 -q 21	random	59	38	4	4	105
HyPo	-m 5 -x -3 -g -8 -n 26 -q 0	mutated	58	41	1	4	104
HyPo	-m 4 -x -2 -g -10 -n 3 -q 29	random	58	39	4	4	105
HyPo	-m 9 -x -6 -g -4 -n 9 -q 21	random	60	44	6	4	114
HyPo	-m 2 -x -10 -g -3 -n 9 -q 28	random	72	46	8	4	130
HyPo	-m 5 -x -4 -g -8 -n 26 -q 0	mutated	58	41	1	4	104
HyPo	-m 2 -x -1 -g -3 -n 12 -q 14	random	58	39	4	4	105
HyPo	-m 5 -x -4 -g -8 -n 23 -q 2	mutated	58	39	4	4	105
HyPo	-m 7 -x -9 -g -6 -n 53 -q 27	random	60	40	6	4	110
HyPo	-m 5 -x -4 -g -8 -n 32 -q 0	mutated	58	41	1	4	104
HyPo	-m 2 -x -4 -g -2 -n 68 -q 50	random	60	41	1	4	106
HyPo	-m 6 -x -3 -g -7 -n 32 -q 6	mutated	58	39	4	4	105
HyPo	-m 3 -x -5 -g -9 -n 75 -q 59	random	58	40	1	4	103
HyPo	-m 4 -x -4 -g -9 -n 75 -q 60	mutated	58	40	1	4	103
HyPo	-m 10 -x -10 -g -10 -n 30 -q 17	random	59	38	4	4	105
HyPo	-m 4 -x -4 -g -9 -n 84 -q 60	mutated	58	40	1	4	103
HyPo	-m 1 -x -8 -g -4 -n 46 -q 39	random	60	40	4	4	108
HyPo	-m 4 -x -4 -g -9 -n 84 -q 52	mutated	58	40	2	4	104
HyPo	-m 6 -x -6 -g -9 -n 42 -q 10	random	58	39	4	4	105
HyPo	-m 4 -x -4 -g -10 -n 84 -q 60	mutated	58	40	1	4	103
HyPo	-m 8 -x -4 -g -2 -n 100 -q 26	random	60	44	6	4	114
HyPo	-m 3 -x -4 -g -11 -n 84 -q 60	mutated	58	40	1	4	103
HyPo	-m 9 -x -7 -g -8 -n 20 -q 55	random	59	39	2	4	104
HyPo	-m 2 -x -4 -g -11 -n 84 -q 60	mutated	58	40	1	4	103
HyPo	-m 10 -x -7 -g 0 -n 89 -q 5	random	inf	inf	inf	inf	inf
HyPo	-m 1 -x -3 -g -10 -n 92 -q 58	mutated	58	40	1	4	103
HyPo	-m 3 -x -8 -g -8 -n 88 -q 3	random	59	38	4	4	105
HyPo	-m 1 -x -3 -g -10 -n 92 -q 60	mutated	58	40	1	4	103
HyPo	-m 3 -x -8 -g -10 -n 84 -q 10	random	58	39	4	4	105
HyPo	-m 1 -x -3 -g -11 -n 92 -q 60	mutated	58	40	1	4	103
HyPo	-m 9 -x -2 -g -10 -n 67 -q 29	random	58	39	4	4	105
HyPo	-m 2 -x -3 -g -11 -n 92 -q 60	mutated	58	40	1	4	103
HyPo	-m 4 -x -10 -g -5 -n 3 -q 48	random	60	41	1	4	106
HyPo	-m 2 -x -3 -g -11 -n 97 -q 60	mutated	58	40	1	4	103
HyPo	-m 8 -x -6 -g -9 -n 1 -q 45	random	59	39	1	4	103
HyPo	-m 8 -x -6 -g -10 -n 1 -q 51	mutated	58	40	2	4	104
HyPo	-m 10 -x -10 -g -7 -n 34 -q 4	random	60	40	6	4	110
HyPo	-m 3 -x -7 -g -9 -n 1 -q 51	random	58	40	1	4	103
HyPo	-m 3 -x -7 -g -8 -n 1 -q 51	mutated	59	39	4	4	106
HyPo	-m 6 -x -4 -g -10 -n 37 -q 3	random	58	39	4	4	105
HyPo	-m 3 -x -7 -g -8 -n 0 -q 51	mutated	59	39	4	4	106
HyPo	-m 5 -x -4 -g -6 -n 21 -q 28	random	59	38	4	4	105
HyPo	-m 2 -x -8 -g -9 -n 1 -q 51	mutated	58	40	1	4	103
HyPo	-m 2 -x -9 -g -8 -n 26 -q 40	random	60	39	4	4	107
HyPo	-m 1 -x -5 -g -9 -n 0 -q 41	random	58	39	1	4	102
HyPo	-m 1 -x -4 -g -9 -n 0 -q 42	mutated	58	40	1	4	103
HyPo	-m 6 -x -10 -g -9 -n 37 -q 35	random	60	39	4	4	107
HyPo	-m 0 -x -10 -g -1 -n 7 -q 52	random	74	46	5	4	129
HyPo	-m 1 -x -5 -g -10 -n 5 -q 41	mutated	58	39	1	4	102
HyPo	-m 0 -x -2 -g -2 -n 98 -q 7	random	58	40	4	4	106
HyPo	-m 7 -x -5 -g -4 -n 44 -q 20	random	60	40	6	4	110
HyPo	-m 1 -x -5 -g -10 -n 0 -q 41	mutated	58	39	1	4	102
HyPo	-m 3 -x 0 -g -2 -n 1 -q 23	random	58	39	4	4	105
HyPo	-m 1 -x -5 -g -10 -n 0 -q 38	mutated	58	39	4	4	105
HyPo	-m 2 -x -9 -g -1 -n 1 -q 27	random	72	47	10	4	133
HyPo	-m 1 -x -5 -g -10 -n 0 -q 39	mutated	58	39	4	4	105
HyPo	-m 1 -x -8 -g -6 -n 38 -q 5	random	60	39	4	4	107
HyPo	-m 3 -x -10 -g -1 -n 40 -q 11	random	72	50	9	4	135
HyPo	-m 0 -x -6 -g -10 -n 0 -q 41	mutated	58	39	1	4	102
HyPo	-m 9 -x 0 -g -2 -n 66 -q 17	random	59	42	6	4	111
HyPo	-m 1 -x -6 -g -10 -n 0 -q 41	mutated	58	39	1	4	102
HyPo	-m 10 -x -2 -g -1 -n 2 -q 47	random	66	47	3	4	120
HyPo	-m 1 -x -6 -g -9 -n 0 -q 41	mutated	58	39	1	4	102
HyPo	-m 5 -x -6 -g -4 -n 56 -q 27	random	60	40	6	4	110
HyPo	-m 8 -x -7 -g -10 -n 86 -q 15	random	59	38	4	4	105
HyPo	-m 4 -x -7 -g -4 -n 63 -q 37	random	60	40	4	4	108
HyPo	-m 1 -x -6 -g -9 -n 0 -q 49	mutated	58	40	1	4	103
HyPo	-m 2 -x -6 -g -1 -n 85 -q 5	random	72	47	9	4	132
HyPo	-m 9 -x -10 -g -3 -n 33 -q 2	random	72	50	9	4	135
HyPo	-m 1 -x -5 -g -8 -n 0 -q 41	mutated	58	39	1	4	102
HyPo	-m 4 -x -1 -g -6 -n 14 -q 4	random	58	39	4	4	105
HyPo	-m 1 -x -4 -g -8 -n 0 -q 41	mutated	58	39	1	4	102
HyPo	-m 6 -x 0 -g -3 -n 6 -q 54	random	58	40	2	4	104
HyPo	-m 1 -x -4 -g -8 -n 0 -q 38	mutated	58	39	4	4	105
HyPo	-m 10 -x -10 -g -9 -n 13 -q 6	random	60	40	6	4	110
HyPo	-m 4 -x -6 -g -1 -n 67 -q 22	random	72	51	10	4	137
HyPo	-m 1 -x -5 -g -8 -n 8 -q 41	mutated	58	39	1	4	102
HyPo	-m 3 -x -3 -g -6 -n 98 -q 46	random	58	40	1	4	103
HyPo	-m 2 -x -9 -g -1 -n 1 -q 14	random	72	47	10	4	133
HyPo	-m 2 -x -4 -g -3 -n 1 -q 0	random	60	41	1	4	106
HyPo	-m 1 -x -5 -g -9 -n 12 -q 41	mutated	58	39	1	4	102
HyPo	-m 5 -x -8 -g -8 -n 78 -q 21	random	59	38	4	4	105
HyPo	-m 0 -x -5 -g -9 -n 12 -q 41	mutated	58	39	1	4	102
HyPo	-m 9 -x 0 -g -3 -n 31 -q 4	random	59	38	6	4	107
HyPo	-m 0 -x -5 -g -9 -n 14 -q 41	mutated	58	39	1	4	102
HyPo	-m 5 -x -8 -g -4 -n 40 -q 40	random	60	41	6	4	111
HyPo	-m 1 -x -4 -g -9 -n 24 -q 41	mutated	58	39	1	4	102
HyPo	-m 9 -x -10 -g -6 -n 1 -q 54	random	60	42	6	4	112
HyPo	-m 1 -x -5 -g -9 -n 30 -q 41	mutated	58	39	1	4	102
HyPo	-m 3 -x -6 -g -7 -n 42 -q 6	random	59	38	4	4	105
HyPo	-m 1 -x -5 -g -8 -n 30 -q 41	mutated	58	39	1	4	102
HyPo	-m 9 -x -3 -g -4 -n 3 -q 38	random	59	38	6	4	107
HyPo	-m 2 -x -5 -g -8 -n 30 -q 49	mutated	58	40	1	4	103
HyPo	-m 7 -x 0 -g -3 -n 9 -q 22	random	59	38	6	4	107
HyPo	-m 2 -x -5 -g -8 -n 30 -q 41	mutated	58	39	1	4	102
HyPo	-m 9 -x -1 -g -5 -n 3 -q 9	random	59	38	4	4	105
HyPo	-m 2 -x -5 -g -7 -n 30 -q 41	mutated	58	39	1	4	102
HyPo	-m 7 -x -1 -g -9 -n 13 -q 3	random	58	39	4	4	105
HyPo	-m 4 -x -9 -g -7 -n 16 -q 0	random	60	41	1	4	106
HyPo	-m 1 -x -6 -g -7 -n 30 -q 41	mutated	58	39	1	4	102
HyPo	-m 6 -x -5 -g -8 -n 5 -q 20	random	58	39	4	4	105
HyPo	-m 0 -x -6 -g -7 -n 30 -q 41	mutated	58	39	1	4	102
HyPo	-m 4 -x -7 -g -9 -n 59 -q 60	random	58	40	1	4	103
HyPo	-m 0 -x -6 -g -7 -n 39 -q 41	mutated	58	39	1	4	102
HyPo	-m 7 -x -8 -g -9 -n 50 -q 11	random	59	38	4	4	105
HyPo	-m 0 -x -5 -g -7 -n 39 -q 41	mutated	58	39	1	4	102
HyPo	-m 6 -x -4 -g -3 -n 0 -q 8	random	60	41	6	4	111
HyPo	-m 3 -x -6 -g -3 -n 2 -q 40	random	60	40	4	4	108
HyPo	-m 1 -x -7 -g -3 -n 79 -q 52	random	72	47	5	4	128
HyPo	-m 0 -x -4 -g -8 -n 36 -q 41	mutated	58	39	1	4	102
HyPo	-m 1 -x -2 -g 0 -n 20 -q 28	random	inf	inf	inf	inf	inf
HyPo	-m 0 -x -4 -g -8 -n 34 -q 41	mutated	58	39	1	4	102
HyPo	-m 1 -x -10 -g -5 -n 42 -q 53	random	60	41	1	4	106
HyPo	-m 0 -x -4 -g -8 -n 39 -q 41	mutated	58	39	1	4	102
HyPo	-m 3 -x -7 -g -6 -n 73 -q 44	random	60	40	1	4	105
HyPo	-m 0 -x -4 -g -8 -n 39 -q 40	mutated	58	39	4	4	105
HyPo	-m 8 -x -8 -g -5 -n 25 -q 57	random	60	42	3	4	109
HyPo	-m 1 -x -4 -g -8 -n 39 -q 41	mutated	58	39	1	4	102
HyPo	-m 2 -x -5 -g -4 -n 63 -q 16	random	60	39	4	4	107
HyPo	-m 2 -x -5 -g -8 -n 39 -q 41	mutated	58	39	1	4	102
HyPo	-m 4 -x -8 -g 0 -n 0 -q 54	random	inf	inf	inf	inf	inf
HyPo	-m 0 -x -6 -g 0 -n 67 -q 10	random	inf	inf	inf	inf	inf
HyPo	-m 3 -x -5 -g -8 -n 30 -q 41	mutated	58	39	1	4	102
HyPo	-m 5 -x -3 -g -6 -n 11 -q 16	random	58	39	4	4	105
HyPo	-m 3 -x -5 -g -8 -n 30 -q 43	mutated	58	40	1	4	103
HyPo	-m 6 -x -7 -g 0 -n 25 -q 30	random	inf	inf	inf	inf	inf
HyPo	-m 3 -x -5 -g -9 -n 26 -q 41	mutated	58	39	1	4	102
HyPo	-m 5 -x -9 -g -3 -n 73 -q 28	random	72	47	10	4	133
HyPo	-m 3 -x -4 -g -9 -n 26 -q 41	mutated	58	39	1	4	102
HyPo	-m 7 -x -4 -g -7 -n 27 -q 38	random	59	38	4	4	105
HyPo	-m 2 -x -5 -g -9 -n 26 -q 41	mutated	58	39	1	4	102
HyPo	-m 8 -x -6 -g -3 -n 46 -q 8	random	60	44	6	4	114
HyPo	-m 1 -x -3 -g -8 -n 57 -q 34	random	58	39	4	4	105
HyPo	-m 2 -x -4 -g -9 -n 22 -q 41	mutated	58	39	1	4	102
HyPo	-m 8 -x -6 -g -3 -n 54 -q 29	random	60	44	6	4	114
HyPo	-m 2 -x -4 -g -9 -n 18 -q 41	mutated	58	39	1	4	102
HyPo	-m 0 -x -8 -g 0 -n 27 -q 24	random	inf	inf	inf	inf	inf
HyPo	-m 2 -x -4 -g -9 -n 18 -q 51	mutated	58	40	2	4	104
HyPo	-m 4 -x -7 -g -9 -n 39 -q 44	random	58	40	1	4	103
HyPo	-m 1 -x -4 -g -9 -n 18 -q 48	mutated	58	40	1	4	103
HyPo	-m 10 -x -3 -g -9 -n 32 -q 32	random	58	39	4	4	105
HyPo	-m 2 -x -5 -g -9 -n 18 -q 41	mutated	58	39	1	4	102
HyPo	-m 6 -x -5 -g -9 -n 29 -q 20	random	58	39	4	4	105
HyPo	-m 10 -x -8 -g -3 -n 11 -q 6	random	72	51	9	4	136
HyPo	-m 7 -x -5 -g -4 -n 14 -q 47	random	60	41	3	4	108
HyPo	-m 1 -x -5 -g -8 -n 18 -q 35	mutated	58	39	4	4	105
HyPo	-m 9 -x 0 -g -5 -n 0 -q 52	random	58	40	2	4	104
HyPo	-m 2 -x -4 -g -8 -n 18 -q 41	mutated	58	39	1	4	102
HyPo	-m 8 -x -5 -g -1 -n 30 -q 21	random	72	51	10	4	137
HyPo	-m 1 -x -4 -g -8 -n 10 -q 40	mutated	58	39	4	4	105
HyPo	-m 5 -x -1 -g -5 -n 7 -q 5	random	58	39	4	4	105
HyPo	-m 3 -x -4 -g -9 -n 23 -q 41	mutated	58	39	1	4	102
HyPo	-m 3 -x -5 -g -7 -n 6 -q 47	random	58	40	1	4	103
HyPo	-m 3 -x -4 -g -10 -n 23 -q 41	mutated	58	39	1	4	102
HyPo	-m 2 -x -3 -g -7 -n 75 -q 53	random	58	40	2	4	104
HyPo	-m 4 -x -4 -g -10 -n 23 -q 43	mutated	58	40	1	4	103
HyPo	-m 6 -x 0 -g -2 -n 2 -q 31	random	59	38	6	4	107
HyPo	-m 3 -x -4 -g -9 -n 23 -q 33	mutated	58	39	4	4	105
HyPo	-m 1 -x -3 -g -5 -n 11 -q 4	random	58	39	4	4	105
HyPo	-m 3 -x -5 -g -10 -n 23 -q 41	mutated	58	39	1	4	102
HyPo	-m 9 -x -5 -g 0 -n 23 -q 3	random	inf	inf	inf	inf	inf
HyPo	-m 4 -x -6 -g -10 -n 23 -q 41	mutated	58	39	1	4	102
HyPo	-m 4 -x -9 -g -8 -n 100 -q 37	random	60	39	4	4	107
HyPo	-m 4 -x -6 -g -9 -n 23 -q 41	mutated	58	39	1	4	102
HyPo	-m 7 -x -10 -g -6 -n 82 -q 35	random	60	40	6	4	110
HyPo	-m 5 -x -6 -g -9 -n 29 -q 35	mutated	58	39	4	4	105
HyPo	-m 7 -x -6 -g -8 -n 46 -q 10	random	59	38	4	4	105
HyPo	-m 3 -x -6 -g -9 -n 23 -q 41	mutated	58	39	1	4	102
HyPo	-m 6 -x -4 -g -9 -n 9 -q 23	random	58	39	4	4	105
HyPo	-m 2 -x -6 -g -9 -n 23 -q 41	mutated	58	39	1	4	102
HyPo	-m 10 -x -7 -g -7 -n 26 -q 26	random	59	38	6	4	107
HyPo	-m 2 -x -5 -g -9 -n 23 -q 41	mutated	58	39	1	4	102
HyPo	-m 1 -x -3 -g -6 -n 23 -q 32	random	58	39	4	4	105
HyPo	-m 1 -x -5 -g -9 -n 31 -q 41	mutated	58	39	1	4	102
HyPo	-m 4 -x -6 -g -7 -n 3 -q 35	random	59	38	4	4	105
HyPo	-m 2 -x -9 -g -4 -n 28 -q 36	random	72	46	8	4	130
HyPo	-m 1 -x -5 -g -9 -n 31 -q 36	mutated	58	39	4	4	105
HyPo	-m 8 -x -9 -g -1 -n 15 -q 58	random	72	52	7	4	135
HyPo	-m 7 -x -3 -g -5 -n 1 -q 13	random	59	38	4	4	105
HyPo	-m 1 -x -4 -g -10 -n 31 -q 41	mutated	58	39	1	4	102
HyPo	-m 9 -x -1 -g -4 -n 0 -q 55	random	59	39	4	4	106
HyPo	-m 1 -x -4 -g -10 -n 39 -q 41	mutated	58	39	1	4	102
HyPo	-m 4 -x -1 -g -10 -n 0 -q 21	random	58	39	4	4	105
HyPo	-m 10 -x -10 -g -3 -n 9 -q 57	random	72	52	7	4	135
HyPo	-m 4 -x -4 -g -9 -n 56 -q 40	random	58	39	4	4	105
HyPo	-m 1 -x -3 -g -10 -n 39 -q 41	mutated	58	39	1	4	102
HyPo	-m 4 -x -7 -g -2 -n 3 -q 24	random	72	47	10	4	133
HyPo	-m 1 -x -3 -g -10 -n 32 -q 41	mutated	58	39	1	4	102
HyPo	-m 3 -x -5 -g -10 -n 0 -q 50	random	58	40	1	4	103
HyPo	-m 0 -x -3 -g -10 -n 32 -q 41	mutated	58	39	1	4	102
HyPo	-m 7 -x 0 -g -9 -n 23 -q 7	random	58	39	4	4	105
HyPo	-m 5 -x -9 -g -8 -n 3 -q 22	random	60	39	4	4	107
HyPo	-m 0 -x -3 -g -10 -n 34 -q 41	mutated	58	39	1	4	102
HyPo	-m 9 -x 0 -g -10 -n 26 -q 13	random	58	39	4	4	105
HyPo	-m 0 -x -3 -g -10 -n 36 -q 41	mutated	58	39	1	4	102
HyPo	-m 8 -x 0 -g -2 -n 56 -q 18	random	59	42	6	4	111
HyPo	-m 0 -x -2 -g -10 -n 31 -q 41	mutated	58	39	1	4	102
HyPo	-m 1 -x -7 -g -9 -n 22 -q 56	random	58	40	1	4	103
HyPo	-m 2 -x 0 -g -3 -n 11 -q 56	random	58	40	1	4	103
HyPo	-m 0 -x -2 -g -9 -n 29 -q 41	mutated	58	39	1	4	102
HyPo	-m 7 -x -5 -g -9 -n 1 -q 18	random	58	39	4	4	105
HyPo	-m 1 -x -2 -g -9 -n 29 -q 41	mutated	58	39	1	4	102
HyPo	-m 8 -x 0 -g -4 -n 28 -q 4	random	58	39	4	4	105
HyPo	-m 2 -x -2 -g -9 -n 29 -q 37	mutated	58	39	4	4	105
HyPo	-m 4 -x -1 -g -7 -n 37 -q 59	random	58	40	1	4	103
HyPo	-m 1 -x -2 -g -9 -n 29 -q 32	mutated	58	39	4	4	105
HyPo	-m 3 -x -2 -g -7 -n 35 -q 17	random	58	39	4	4	105
HyPo	-m 1 -x -2 -g -8 -n 29 -q 41	mutated	58	39	1	4	102
HyPo	-m 6 -x -1 -g -10 -n 80 -q 17	random	58	39	4	4	105
HyPo	-m 9 -x -3 -g -10 -n 42 -q 50	random	58	40	1	4	103
HyPo	-m 3 -x -6 -g -1 -n 13 -q 25	random	72	50	10	4	136
HyPo	-m 1 -x -1 -g -8 -n 29 -q 41	mutated	58	39	1	4	102
HyPo	-m 6 -x -2 -g -8 -n 72 -q 11	random	58	39	4	4	105
HyPo	-m 5 -x -6 -g -4 -n 50 -q 55	random	60	41	6	4	111
HyPo	-m 1 -x -1 -g -7 -n 22 -q 41	mutated	58	39	1	4	102
HyPo	-m 0 -x -7 -g -10 -n 27 -q 19	random	58	39	4	4	105
HyPo	-m 1 -x -1 -g -8 -n 22 -q 31	mutated	58	39	4	4	105
HyPo	-m 4 -x 0 -g -3 -n 24 -q 58	random	58	40	1	4	103
HyPo	-m 0 -x -1 -g -8 -n 23 -q 41	mutated	58	39	1	4	102
HyPo	-m 5 -x -6 -g -10 -n 79 -q 23	random	58	39	4	4	105
HyPo	-m 0 -x 0 -g -8 -n 23 -q 34	mutated	248	194	178	202	822
HyPo	-m 5 -x -4 -g 0 -n 3 -q 30	random	inf	inf	inf	inf	inf
HyPo	-m 0 -x 0 -g -8 -n 16 -q 41	mutated	248	191	174	188	801
HyPo	-m 9 -x -8 -g -8 -n 10 -q 40	random	59	38	6	4	107
HyPo	-m 0 -x -2 -g -8 -n 23 -q 41	mutated	58	39	1	4	102
HyPo	-m 0 -x 0 -g -8 -n 26 -q 0	random	248	237	193	221	899
HyPo	-m 0 -x -3 -g -8 -n 13 -q 42	mutated	58	40	1	4	103
HyPo	-m 1 -x -1 -g -2 -n 3 -q 13	random	58	39	4	4	105
HyPo	-m 0 -x -2 -g -8 -n 28 -q 42	mutated	58	40	1	4	103
HyPo	-m 7 -x -8 -g -6 -n 59 -q 19	random	60	40	6	4	110
HyPo	-m 0 -x -2 -g -8 -n 13 -q 41	mutated	58	39	1	4	102
HyPo	-m 1 -x -2 -g -2 -n 9 -q 28	random	59	38	4	4	105
HyPo	-m 0 -x -2 -g -7 -n 13 -q 41	mutated	58	39	1	4	102
HyPo	-m 0 -x -4 -g -4 -n 33 -q 41	random	58	40	1	4	103
HyPo	-m 0 -x -1 -g -7 -n 13 -q 41	mutated	58	39	1	4	102
HyPo	-m 3 -x -8 -g -10 -n 37 -q 0	random	58	41	1	4	104
HyPo	-m 0 -x -1 -g -7 -n 22 -q 41	mutated	58	39	1	4	102
HyPo	-m 0 -x 0 -g -4 -n 12 -q 0	random	248	237	193	221	899
HyPo	-m 0 -x -1 -g -7 -n 21 -q 41	mutated	58	39	1	4	102
HyPo	-m 1 -x 0 -g -4 -n 23 -q 5	random	58	39	4	4	105
HyPo	-m 1 -x -1 -g -7 -n 21 -q 41	mutated	58	39	1	4	102
HyPo	-m 2 -x 0 -g -5 -n 62 -q 34	random	58	39	4	4	105
HyPo	-m 0 -x -1 -g -7 -n 15 -q 41	mutated	58	39	1	4	102
HyPo	-m 0 -x -9 -g -9 -n 25 -q 54	random	58	41	1	4	104
HyPo	-m 7 -x -5 -g -8 -n 91 -q 28	random	59	38	4	4	105
HyPo	-m 0 -x -1 -g -7 -n 5 -q 41	mutated	58	39	1	4	102
HyPo	-m 4 -x -8 -g -7 -n 41 -q 41	random	60	39	1	4	104
HyPo	-m 0 -x -2 -g -8 -n 5 -q 41	mutated	58	39	1	4	102
HyPo	-m 2 -x -3 -g 0 -n 84 -q 0	random	inf	inf	inf	inf	inf
HyPo	-m 0 -x -1 -g -7 -n 5 -q 47	mutated	58	40	1	4	103
HyPo	-m 3 -x -2 -g -9 -n 53 -q 45	random	58	40	1	4	103
HyPo	-m 0 -x -2 -g -8 -n 5 -q 36	mutated	58	39	4	4	105
HyPo	-m 5 -x -1 -g -2 -n 2 -q 22	random	59	38	6	4	107
HyPo	-m 0 -x -2 -g -7 -n 5 -q 41	mutated	58	39	1	4	102
HyPo	-m 1 -x -1 -g -2 -n 34 -q 10	random	58	39	4	4	105
HyPo	-m 0 -x -2 -g -6 -n 5 -q 41	mutated	58	39	1	4	102
HyPo	-m 1 -x -3 -g -7 -n 1 -q 52	random	58	40	2	4	104
HyPo	-m 0 -x -3 -g -6 -n 5 -q 41	mutated	58	39	1	4	102
HyPo	-m 2 -x -3 -g -3 -n 65 -q 23	random	59	38	4	4	105
HyPo	-m 10 -x -1 -g -7 -n 7 -q 10	random	58	39	4	4	105
HyPo	-m 5 -x -2 -g 0 -n 99 -q 53	random	inf	inf	inf	inf	inf
HyPo	-m 0 -x -3 -g -5 -n 5 -q 41	mutated	58	39	1	4	102
HyPo	-m 1 -x -10 -g -4 -n 70 -q 48	random	72	47	4	4	127
HyPo	-m 0 -x -2 -g -4 -n 5 -q 39	mutated	58	39	4	4	105
HyPo	-m 3 -x -2 -g -2 -n 19 -q 40	random	59	38	6	4	107
HyPo	-m 0 -x -3 -g -5 -n 10 -q 41	mutated	58	39	1	4	102
HyPo	-m 4 -x -7 -g -4 -n 14 -q 12	random	60	40	4	4	108
HyPo	-m 0 -x -3 -g -4 -n 10 -q 34	mutated	58	39	4	4	105
HyPo	-m 5 -x -7 -g -8 -n 3 -q 36	random	59	38	4	4	105
HyPo	-m 1 -x -3 -g -5 -n 10 -q 41	mutated	58	39	1	4	102
HyPo	-m 8 -x -10 -g 0 -n 35 -q 19	random	inf	inf	inf	inf	inf
HyPo	-m 0 -x -4 -g -6 -n 10 -q 41	mutated	58	39	1	4	102
HyPo	-m 0 -x -8 -g -3 -n 77 -q 39	random	74	45	8	4	131
HyPo	-m 0 -x -3 -g -6 -n 10 -q 41	mutated	58	39	1	4	102
HyPo	-m 3 -x -5 -g -2 -n 57 -q 2	random	72	47	9	4	132
HyPo	-m 5 -x -10 -g -5 -n 2 -q 16	random	60	40	4	4	108
HyPo	-m 5 -x -5 -g 0 -n 49 -q 36	random	inf	inf	inf	inf	inf
HyPo	-m 0 -x -3 -g -6 -n 17 -q 31	mutated	58	39	4	4	105
HyPo	-m 9 -x 0 -g -9 -n 54 -q 0	random	58	41	1	4	104
HyPo	-m 10 -x -10 -g -7 -n 3 -q 23	random	60	40	6	4	110
HyPo	-m 1 -x -3 -g -6 -n 10 -q 41	mutated	58	39	1	4	102
HyPo	-m 4 -x -3 -g -3 -n 7 -q 24	random	59	38	6	4	107
HyPo	-m 1 -x -3 -g -6 -n 9 -q 41	mutated	58	39	1	4	102
HyPo	-m 1 -x -6 -g 0 -n 82 -q 9	random	inf	inf	inf	inf	inf
HyPo	-m 4 -x -3 -g -1 -n 49 -q 54	random	72	52	7	4	135
HyPo	-m 2 -x -5 -g -10 -n 5 -q 32	random	58	39	4	4	105
HyPo	-m 1 -x -3 -g -5 -n 9 -q 41	mutated	58	39	1	4	102
HyPo	-m 1 -x -4 -g -6 -n 12 -q 17	random	58	39	4	4	105
HyPo	-m 1 -x -3 -g -5 -n 9 -q 45	mutated	58	40	1	4	103
HyPo	-m 0 -x -5 -g -4 -n 50 -q 30	random	60	39	4	4	107
HyPo	-m 1 -x -4 -g -5 -n 9 -q 41	mutated	58	39	1	4	102
HyPo	-m 4 -x -5 -g -1 -n 60 -q 18	random	72	51	10	4	137
HyPo	-m 0 -x -4 -g -4 -n 9 -q 41	mutated	58	40	1	4	103
HyPo	-m 2 -x -10 -g -5 -n 6 -q 7	random	60	40	4	4	108
HyPo	-m 5 -x -4 -g -5 -n 37 -q 9	random	59	38	4	4	105
HyPo	-m 1 -x -4 -g -5 -n 17 -q 41	mutated	58	39	1	4	102
HyPo	-m 2 -x -9 -g -10 -n 6 -q 26	random	58	39	4	4	105
HyPo	-m 1 -x -4 -g -5 -n 11 -q 41	mutated	58	39	1	4	102
HyPo	-m 6 -x -8 -g -3 -n 35 -q 31	random	72	47	10	4	133
HyPo	-m 2 -x -4 -g -5 -n 11 -q 41	mutated	58	39	1	4	102
HyPo	-m 3 -x 0 -g -4 -n 54 -q 32	random	58	39	4	4	105
HyPo	-m 2 -x -4 -g -5 -n 15 -q 37	mutated	58	39	4	4	105
HyPo	-m 2 -x -8 -g -9 -n 2 -q 60	random	58	40	1	4	103
HyPo	-m 2 -x -3 -g -5 -n 11 -q 41	mutated	58	39	1	4	102
HyPo	-m 9 -x -7 -g -4 -n 2 -q 34	random	60	44	6	4	114
HyPo	-m 3 -x -3 -g -4 -n 11 -q 41	mutated	59	38	1	4	102
HyPo	-m 8 -x -8 -g -9 -n 37 -q 7	random	59	38	4	4	105
HyPo	-m 3 -x -3 -g -4 -n 11 -q 31	mutated	59	38	4	4	105
HyPo	-m 3 -x -9 -g -9 -n 74 -q 59	random	59	39	1	4	103
HyPo	-m 3 -x -3 -g -3 -n 11 -q 41	mutated	59	38	1	4	102
HyPo	-m 9 -x -6 -g -8 -n 2 -q 11	random	59	38	4	4	105
HyPo	-m 3 -x -2 -g -3 -n 11 -q 41	mutated	59	38	1	4	102
HyPo	-m 1 -x -6 -g -1 -n 3 -q 26	random	72	46	8	4	130
HyPo	-m 6 -x -7 -g -9 -n 0 -q 51	random	59	39	4	4	106
HyPo	-m 3 -x -2 -g -2 -n 11 -q 44	mutated	59	39	3	4	105
HyPo	-m 3 -x -8 -g -3 -n 35 -q 40	random	72	46	8	4	130
HyPo	-m 4 -x -2 -g -3 -n 11 -q 41	mutated	59	38	1	4	102
HyPo	-m 3 -x -10 -g -4 -n 69 -q 27	random	72	46	8	4	130
HyPo	-m 7 -x 0 -g 0 -n 0 -q 10	random	inf	inf	inf	inf	inf
HyPo	-m 3 -x -2 -g -3 -n 18 -q 41	mutated	59	38	1	4	102
HyPo	-m 6 -x -10 -g 0 -n 58 -q 2	random	inf	inf	inf	inf	inf
HyPo	-m 4 -x -1 -g -3 -n 26 -q 41	mutated	58	39	1	4	102
HyPo	-m 3 -x -9 -g -9 -n 29 -q 40	random	59	38	4	4	105
HyPo	-m 9 -x -9 -g -2 -n 39 -q 57	random	72	52	7	4	135
HyPo	-m 0 -x -8 -g -5 -n 93 -q 0	random	60	41	1	4	106
HyPo	-m 4 -x -2 -g -4 -n 26 -q 41	mutated	58	39	1	4	102
HyPo	-m 3 -x -1 -g -4 -n 73 -q 6	random	58	39	4	4	105
HyPo	-m 4 -x -2 -g -4 -n 26 -q 43	mutated	58	40	1	4	103
HyPo	-m 5 -x -4 -g -10 -n 10 -q 13	random	58	39	4	4	105
HyPo	-m 4 -x -3 -g -4 -n 26 -q 51	mutated	59	39	2	4	104
HyPo	-m 2 -x -5 -g 0 -n 25 -q 7	random	inf	inf	inf	inf	inf
HyPo	-m 4 -x -1 -g -3 -n 32 -q 35	mutated	58	39	4	4	105
HyPo	-m 9 -x -7 -g -10 -n 43 -q 36	random	59	38	4	4	105
HyPo	-m 4 -x -2 -g -4 -n 28 -q 41	mutated	58	39	1	4	102
HyPo	-m 8 -x -6 -g -1 -n 37 -q 22	random	72	51	10	4	137
HyPo	-m 6 -x -10 -g -6 -n 69 -q 18	random	60	40	4	4	108
HyPo	-m 4 -x -2 -g -5 -n 28 -q 39	mutated	58	39	4	4	105
HyPo	-m 0 -x -4 -g -6 -n 8 -q 51	random	58	40	2	4	104
HyPo	-m 4 -x -2 -g -5 -n 37 -q 39	mutated	58	39	4	4	105
HyPo	-m 1 -x -3 -g -5 -n 66 -q 35	random	58	39	4	4	105
HyPo	-m 4 -x -2 -g -5 -n 29 -q 41	mutated	58	39	1	4	102
HyPo	-m 7 -x -9 -g -3 -n 87 -q 41	random	72	50	6	4	132
HyPo	-m 4 -x -1 -g -5 -n 29 -q 41	mutated	58	39	1	4	102
HyPo	-m 6 -x -5 -g -2 -n 4 -q 22	random	72	50	10	4	136
HyPo	-m 4 -x -1 -g -5 -n 31 -q 41	mutated	58	39	1	4	102
HyPo	-m 8 -x -7 -g -10 -n 41 -q 46	random	59	39	1	4	103
HyPo	-m 3 -x -1 -g -5 -n 31 -q 41	mutated	58	39	1	4	102
HyPo	-m 5 -x 0 -g -4 -n 39 -q 25	random	58	39	4	4	105
HyPo	-m 2 -x -1 -g -6 -n 31 -q 41	mutated	58	39	1	4	102
HyPo	-m 10 -x -2 -g -3 -n 55 -q 2	random	59	42	6	4	111
HyPo	-m 2 -x -1 -g -6 -n 35 -q 43	mutated	58	40	1	4	103
HyPo	-m 8 -x -4 -g -6 -n 67 -q 49	random	59	39	1	4	103
HyPo	-m 2 -x -2 -g -6 -n 31 -q 41	mutated	58	39	1	4	102
HyPo	-m 0 -x -1 -g -4 -n 62 -q 7	random	58	39	4	4	105
HyPo	-m 3 -x -3 -g -6 -n 31 -q 41	mutated	58	39	1	4	102
HyPo	-m 6 -x -8 -g -6 -n 7 -q 16	random	60	40	4	4	108
HyPo	-m 3 -x -4 -g -6 -n 31 -q 41	mutated	58	39	1	4	102
HyPo	-m 2 -x -7 -g -7 -n 45 -q 27	random	59	38	4	4	105
HyPo	-m 3 -x -4 -g -5 -n 31 -q 41	mutated	59	38	1	4	102
HyPo	-m 4 -x -10 -g -2 -n 84 -q 18	random	72	47	10	4	133
HyPo	-m 3 -x -4 -g -5 -n 35 -q 41	mutated	59	38	1	4	102
HyPo	-m 3 -x -8 -g -4 -n 1 -q 13	random	60	40	4	4	108
HyPo	-m 3 -x -4 -g -4 -n 35 -q 31	mutated	59	38	4	4	105
HyPo	-m 8 -x -7 -g -4 -n 5 -q 17	random	60	41	6	4	111
HyPo	-m 3 -x -4 -g -6 -n 35 -q 41	mutated	58	39	1	4	102
HyPo	-m 3 -x -9 -g -2 -n 8 -q 3	random	72	47	9	4	132
HyPo	-m 6 -x 0 -g -9 -n 3 -q 52	random	58	40	2	4	104
HyPo	-m 5 -x -7 -g -3 -n 74 -q 16	random	72	47	10	4	133
HyPo	-m 3 -x -3 -g -6 -n 35 -q 41	mutated	58	39	1	4	102
HyPo	-m 7 -x -5 -g -1 -n 52 -q 46	random	72	52	6	4	134
HyPo	-m 0 -x -8 -g -5 -n 20 -q 0	random	60	41	1	4	106
HyPo	-m 3 -x -4 -g -6 -n 26 -q 47	mutated	58	40	1	4	103
HyPo	-m 5 -x 0 -g -4 -n 13 -q 1	random	58	39	4	4	105
HyPo	-m 3 -x -2 -g -6 -n 35 -q 41	mutated	58	39	1	4	102
HyPo	-m 8 -x -10 -g -5 -n 48 -q 56	random	60	42	3	4	109
HyPo	-m 3 -x -2 -g -6 -n 35 -q 39	mutated	58	39	4	4	105
HyPo	-m 5 -x -3 -g -3 -n 49 -q 14	random	59	38	6	4	107
HyPo	-m 3 -x -2 -g -4 -n 44 -q 13	random	58	39	4	4	105
HyPo	-m 2 -x -10 -g -10 -n 18 -q 12	random	59	38	4	4	105
HyPo	-m 3 -x -2 -g -5 -n 35 -q 41	mutated	58	39	1	4	102
HyPo	-m 5 -x -2 -g -6 -n 3 -q 27	random	58	39	4	4	105
HyPo	-m 10 -x -6 -g -10 -n 15 -q 0	random	59	40	1	4	104
HyPo	-m 3 -x -1 -g -6 -n 26 -q 41	mutated	58	39	1	4	102
HyPo	-m 2 -x -4 -g -5 -n 70 -q 43	random	58	40	1	4	103
HyPo	-m 3 -x -1 -g -5 -n 26 -q 41	mutated	58	39	1	4	102
HyPo	-m 1 -x -7 -g -9 -n 42 -q 23	random	58	39	4	4	105
HyPo	-m 3 -x -2 -g -5 -n 26 -q 41	mutated	58	39	1	4	102
HyPo	-m 7 -x -4 -g -6 -n 0 -q 41	random	59	38	1	4	102
HyPo	-m 9 -x -7 -g -6 -n 13 -q 59	random	60	41	3	4	108
HyPo	-m 4 -x -2 -g -1 -n 10 -q 4	random	60	44	6	4	114
HyPo	-m 8 -x -4 -g -6 -n 0 -q 47	mutated	59	39	1	4	103
HyPo	-m 3 -x -6 -g -10 -n 31 -q 44	random	58	40	1	4	103
HyPo	-m 8 -x -5 -g -6 -n 6 -q 41	mutated	59	38	3	4	104
HyPo	-m 2 -x 0 -g -5 -n 0 -q 39	random	58	39	4	4	105
HyPo	-m 7 -x -5 -g -5 -n 0 -q 41	mutated	59	38	3	4	104
HyPo	-m 1 -x -1 -g -4 -n 6 -q 40	random	58	39	4	4	105
HyPo	-m 6 -x -3 -g -6 -n 0 -q 48	mutated	58	40	1	4	103
HyPo	-m 3 -x 0 -g -2 -n 64 -q 33	random	58	39	4	4	105
HyPo	-m 8 -x -4 -g -5 -n 0 -q 41	mutated	59	38	3	4	104
HyPo	-m 7 -x -9 -g -6 -n 6 -q 35	random	60	40	6	4	110
HyPo	-m 8 -x -3 -g -6 -n 0 -q 41	mutated	59	38	1	4	102
HyPo	-m 9 -x -9 -g -6 -n 28 -q 6	random	60	40	6	4	110
HyPo	-m 8 -x -2 -g -7 -n 2 -q 49	random	58	40	1	4	103
HyPo	-m 8 -x -3 -g -6 -n 10 -q 31	mutated	59	38	4	4	105
HyPo	-m 0 -x -7 -g -4 -n 63 -q 49	random	60	40	1	4	105
HyPo	-m 8 -x -2 -g -6 -n 0 -q 41	mutated	58	39	1	4	102
HyPo	-m 0 -x 0 -g -7 -n 56 -q 52	random	248	192	174	188	802
HyPo	-m 9 -x -2 -g -6 -n 0 -q 41	mutated	59	38	1	4	102
HyPo	-m 6 -x -5 -g -4 -n 63 -q 23	random	60	40	6	4	110
HyPo	-m 9 -x -3 -g -6 -n 0 -q 41	mutated	59	38	1	4	102
HyPo	-m 6 -x -3 -g -5 -n 13 -q 2	random	59	38	4	4	105
HyPo	-m 0 -x -5 -g 0 -n 92 -q 18	random	inf	inf	inf	inf	inf
HyPo	-m 3 -x -2 -g -6 -n 41 -q 1	random	58	39	4	4	105
HyPo	-m 10 -x -2 -g -6 -n 0 -q 34	mutated	59	38	4	4	105
HyPo	-m 7 -x -5 -g -9 -n 21 -q 43	random	58	40	1	4	103
HyPo	-m 10 -x -1 -g -6 -n 24 -q 13	random	58	39	4	4	105
HyPo	-m 4 -x -5 -g -5 -n 11 -q 28	random	59	38	4	4	105
HyPo	-m 10 -x -3 -g -2 -n 46 -q 38	random	61	46	6	4	117
HyPo	-m 5 -x -2 -g -9 -n 16 -q 1	random	58	39	4	4	105
HyPo	-m 9 -x -2 -g -6 -n 0 -q 37	mutated	59	38	4	4	105
HyPo	-m 5 -x -4 -g -2 -n 6 -q 47	random	60	45	3	4	112
HyPo	-m 4 -x -1 -g -5 -n 4 -q 8	random	58	39	4	4	105
HyPo	-m 9 -x -2 -g -6 -n 0 -q 49	mutated	59	39	1	4	103
HyPo	-m 3 -x -7 -g -1 -n 0 -q 51	random	72	51	7	4	134
HyPo	-m 2 -x 0 -g -2 -n 25 -q 25	random	58	39	4	4	105
HyPo	-m 9 -x -3 -g -5 -n 0 -q 41	mutated	59	38	3	4	104
HyPo	-m 1 -x -9 -g -6 -n 12 -q 58	random	60	40	1	4	105
HyPo	-m 9 -x -5 -g -10 -n 53 -q 45	random	58	40	1	4	103
HyPo	-m 9 -x -3 -g -6 -n 0 -q 39	mutated	59	38	4	4	105
HyPo	-m 5 -x -3 -g -6 -n 3 -q 55	random	58	40	2	4	104
HyPo	-m 9 -x -2 -g -7 -n 0 -q 35	mutated	58	39	4	4	105
HyPo	-m 0 -x -8 -g -4 -n 50 -q 9	random	62	40	4	4	110
HyPo	-m 5 -x -8 -g -10 -n 42 -q 45	random	59	39	1	4	103
HyPo	-m 9 -x -3 -g -6 -n 0 -q 45	mutated	59	39	1	4	103
HyPo	-m 4 -x 0 -g -7 -n 67 -q 45	random	58	40	1	4	103
HyPo	-m 10 -x -3 -g -6 -n 0 -q 41	mutated	59	38	3	4	104
HyPo	-m 3 -x -10 -g -8 -n 92 -q 52	random	60	40	1	4	105
HyPo	-m 5 -x -6 -g -9 -n 67 -q 11	random	58	39	4	4	105
HyPo	-m 1 -x -4 -g -10 -n 10 -q 57	random	58	40	1	4	103
HyPo	-m 10 -x -4 -g -5 -n 0 -q 41	mutated	59	38	3	4	104
HyPo	-m 5 -x -1 -g -3 -n 89 -q 57	random	59	39	1	4	103
HyPo	-m 2 -x -5 -g -3 -n 10 -q 59	random	60	41	1	4	106
HyPo	-m 9 -x -3 -g -6 -n 7 -q 41	mutated	59	38	1	4	102
HyPo	-m 3 -x 0 -g -6 -n 37 -q 60	random	58	40	1	4	103
HyPo	-m 9 -x -2 -g -6 -n 10 -q 41	mutated	59	38	1	4	102
HyPo	-m 2 -x -6 -g 0 -n 78 -q 18	random	inf	inf	inf	inf	inf
HyPo	-m 8 -x -2 -g -9 -n 14 -q 25	random	58	39	4	4	105
HyPo	-m 9 -x -2 -g -5 -n 10 -q 41	mutated	59	38	3	4	104
HyPo	-m 10 -x -9 -g -1 -n 57 -q 3	random	77	53	9	4	143
HyPo	-m 0 -x -10 -g -9 -n 15 -q 19	random	60	39	4	4	107
HyPo	-m 9 -x -2 -g -6 -n 12 -q 34	mutated	59	38	4	4	105
HyPo	-m 6 -x -1 -g -4 -n 9 -q 60	random	58	40	1	4	103
HyPo	-m 8 -x -2 -g -6 -n 10 -q 41	mutated	58	39	1	4	102
HyPo	-m 2 -x -4 -g -1 -n 12 -q 49	random	72	48	6	4	130
HyPo	-m 8 -x -3 -g -6 -n 10 -q 41	mutated	59	38	1	4	102
HyPo	-m 9 -x -9 -g -7 -n 29 -q 41	random	60	40	3	4	107
HyPo	-m 8 -x -3 -g -7 -n 10 -q 41	mutated	58	39	1	4	102
HyPo	-m 4 -x -4 -g -10 -n 37 -q 39	random	58	39	4	4	105
HyPo	-m 8 -x -4 -g -8 -n 10 -q 35	mutated	58	39	4	4	105
HyPo	-m 4 -x -2 -g -3 -n 9 -q 35	random	59	38	4	4	105
HyPo	-m 6 -x -9 -g -2 -n 36 -q 19	random	72	50	10	4	136
HyPo	-m 9 -x 0 -g -3 -n 28 -q 45	random	59	39	3	4	105
HyPo	-m 7 -x -3 -g -7 -n 10 -q 41	mutated	58	39	1	4	102
HyPo	-m 5 -x -8 -g -8 -n 74 -q 58	random	59	39	1	4	103
HyPo	-m 7 -x -4 -g -7 -n 20 -q 41	mutated	59	38	1	4	102
HyPo	-m 6 -x -1 -g -7 -n 18 -q 37	random	58	39	4	4	105
HyPo	-m 5 -x -10 -g -5 -n 11 -q 23	random	60	40	4	4	108
HyPo	-m 8 -x -1 -g 0 -n 43 -q 45	random	inf	inf	inf	inf	inf
HyPo	-m 7 -x -3 -g -7 -n 20 -q 41	mutated	58	39	1	4	102
HyPo	-m 1 -x -10 -g -8 -n 1 -q 10	random	60	39	4	4	107
HyPo	-m 7 -x -3 -g -8 -n 20 -q 34	mutated	58	39	4	4	105
HyPo	-m 0 -x -1 -g -9 -n 99 -q 3	random	58	39	4	4	105
HyPo	-m 7 -x -3 -g -8 -n 20 -q 41	mutated	58	39	1	4	102
HyPo	-m 2 -x -5 -g -6 -n 34 -q 25	random	58	39	4	4	105
HyPo	-m 3 -x -7 -g -7 -n 62 -q 31	random	59	38	4	4	105
HyPo	-m 7 -x -3 -g -8 -n 20 -q 51	mutated	58	40	2	4	104
HyPo	-m 5 -x 0 -g -8 -n 30 -q 51	random	58	40	2	4	104
HyPo	-m 9 -x -4 -g -8 -n 97 -q 49	random	59	39	1	4	103
HyPo	-m 7 -x -2 -g -8 -n 11 -q 41	mutated	58	39	1	4	102
HyPo	-m 3 -x 0 -g -7 -n 2 -q 50	random	58	40	1	4	103
HyPo	-m 6 -x -4 -g -9 -n 22 -q 2	random	58	39	4	4	105
HyPo	-m 7 -x -2 -g -7 -n 16 -q 41	mutated	58	39	1	4	102
HyPo	-m 6 -x -8 -g -6 -n 93 -q 36	random	60	40	4	4	108
HyPo	-m 6 -x -2 -g -8 -n 16 -q 50	mutated	58	40	1	4	103
HyPo	-m 10 -x -7 -g -7 -n 0 -q 35	random	59	38	6	4	107
HyPo	-m 2 -x -3 -g -2 -n 82 -q 27	random	60	40	4	4	108
HyPo	-m 7 -x -2 -g -7 -n 17 -q 41	mutated	58	39	1	4	102
HyPo	-m 0 -x -5 -g 0 -n 46 -q 0	random	inf	inf	inf	inf	inf
HyPo	-m 7 -x -1 -g -7 -n 17 -q 41	mutated	58	39	1	4	102
HyPo	-m 4 -x -3 -g 0 -n 73 -q 22	random	inf	inf	inf	inf	inf
HyPo	-m 8 -x -6 -g -10 -n 14 -q 20	random	58	39	4	4	105
HyPo	-m 2 -x -7 -g -2 -n 24 -q 15	random	72	46	8	4	130
HyPo	-m 7 -x 0 -g -7 -n 17 -q 41	mutated	58	39	1	4	102
HyPo	-m 1 -x -9 -g 0 -n 37 -q 26	random	inf	inf	inf	inf	inf
HyPo	-m 7 -x 0 -g -6 -n 16 -q 41	mutated	58	39	1	4	102
HyPo	-m 1 -x -7 -g -4 -n 69 -q 31	random	60	39	4	4	107
HyPo	-m 8 -x 0 -g -6 -n 16 -q 40	mutated	58	39	4	4	105
HyPo	-m 4 -x -1 -g -1 -n 16 -q 42	random	59	43	3	4	109
HyPo	-m 7 -x 0 -g -6 -n 22 -q 41	mutated	58	39	1	4	102
HyPo	-m 8 -x 0 -g -1 -n 15 -q 56	random	60	45	3	4	112
HyPo	-m 7 -x -1 -g -6 -n 21 -q 49	mutated	58	40	1	4	103
HyPo	-m 2 -x -6 -g -4 -n 16 -q 22	random	60	39	4	4	107
HyPo	-m 1 -x -9 -g -2 -n 16 -q 23	random	72	46	8	4	130
HyPo	-m 7 -x 0 -g -7 -n 22 -q 41	mutated	58	39	1	4	102
HyPo	-m 5 -x -7 -g -5 -n 38 -q 24	random	60	40	4	4	108
HyPo	-m 8 -x 0 -g -7 -n 22 -q 41	mutated	58	39	1	4	102
HyPo	-m 3 -x 0 -g -7 -n 66 -q 0	random	58	41	1	4	104
HyPo	-m 7 -x 0 -g -7 -n 25 -q 41	mutated	58	39	1	4	102
HyPo	-m 7 -x -9 -g -1 -n 11 -q 28	random	72	51	10	4	137
HyPo	-m 3 -x -7 -g 0 -n 29 -q 2	random	inf	inf	inf	inf	inf
HyPo	-m 7 -x 0 -g -7 -n 15 -q 41	mutated	58	39	1	4	102
HyPo	-m 2 -x -8 -g -8 -n 16 -q 16	random	59	38	4	4	105
HyPo	-m 8 -x 0 -g -7 -n 15 -q 41	mutated	58	39	1	4	102
HyPo	-m 7 -x -9 -g 0 -n 27 -q 60	random	inf	inf	inf	inf	inf
HyPo	-m 8 -x 0 -g -7 -n 10 -q 41	mutated	58	39	1	4	102
HyPo	-m 1 -x -10 -g -3 -n 26 -q 47	random	72	47	4	4	127
HyPo	-m 9 -x 0 -g -6 -n 7 -q 41	mutated	58	39	1	4	102
HyPo	-m 5 -x -7 -g -4 -n 4 -q 9	random	60	40	6	4	110
HyPo	-m 8 -x 0 -g -6 -n 7 -q 41	mutated	58	39	1	4	102
HyPo	-m 3 -x -4 -g -4 -n 40 -q 4	random	59	38	4	4	105
HyPo	-m 7 -x 0 -g -6 -n 7 -q 41	mutated	58	39	1	4	102
HyPo	-m 8 -x -4 -g -2 -n 14 -q 17	random	60	44	6	4	114
HyPo	-m 7 -x 0 -g -6 -n 7 -q 37	mutated	58	39	4	4	105
HyPo	-m 7 -x -3 -g -2 -n 1 -q 11	random	60	44	6	4	114
HyPo	-m 7 -x 0 -g -7 -n 7 -q 41	mutated	58	39	1	4	102
HyPo	-m 4 -x -6 -g -3 -n 53 -q 0	random	60	43	3	4	110
HyPo	-m 6 -x 0 -g -7 -n 7 -q 41	mutated	58	39	1	4	102
HyPo	-m 10 -x -9 -g 0 -n 28 -q 22	random	inf	inf	inf	inf	inf
HyPo	-m 2 -x -1 -g -9 -n 65 -q 53	random	58	40	2	4	104
HyPo	-m 7 -x -1 -g -7 -n 12 -q 50	random	58	40	1	4	103
HyPo	-m 5 -x -1 -g -7 -n 0 -q 47	mutated	58	40	1	4	103
HyPo	-m 9 -x -6 -g -7 -n 0 -q 30	random	59	38	6	4	107
HyPo	-m 6 -x 0 -g -6 -n 7 -q 41	mutated	58	39	1	4	102
HyPo	-m 0 -x -4 -g -6 -n 1 -q 3	random	58	39	4	4	105
HyPo	-m 3 -x -1 -g -4 -n 39 -q 40	random	58	39	4	4	105
HyPo	-m 6 -x 0 -g -6 -n 16 -q 41	mutated	58	39	1	4	102
HyPo	-m 6 -x -1 -g -5 -n 32 -q 33	random	58	39	4	4	105
HyPo	-m 2 -x -10 -g -4 -n 12 -q 15	random	72	46	8	4	130
HyPo	-m 7 -x -7 -g -7 -n 6 -q 25	random	59	38	4	4	105
HyPo	-m 9 -x -10 -g -4 -n 2 -q 35	random	72	50	10	4	136
HyPo	-m 5 -x 0 -g -6 -n 16 -q 41	mutated	58	39	1	4	102
HyPo	-m 9 -x -2 -g -5 -n 0 -q 43	random	59	39	3	4	105
HyPo	-m 5 -x 0 -g -6 -n 13 -q 41	mutated	58	39	1	4	102
HyPo	-m 9 -x -7 -g -6 -n 55 -q 16	random	60	40	6	4	110
HyPo	-m 5 -x 0 -g -6 -n 11 -q 41	mutated	58	39	1	4	102
HyPo	-m 5 -x -8 -g -9 -n 1 -q 53	random	59	39	4	4	106
HyPo	-m 6 -x -6 -g -1 -n 16 -q 18	random	72	51	10	4	137
HyPo	-m 5 -x 0 -g -6 -n 11 -q 37	mutated	58	39	4	4	105
HyPo	-m 3 -x -8 -g -9 -n 23 -q 39	random	59	38	4	4	105
HyPo	-m 9 -x -6 -g -1 -n 68 -q 30	random	72	51	10	4	137
HyPo	-m 5 -x 0 -g -7 -n 11 -q 41	mutated	58	39	1	4	102
HyPo	-m 2 -x -8 -g -7 -n 73 -q 2	random	60	39	4	4	107
HyPo	-m 5 -x 0 -g -8 -n 11 -q 41	mutated	58	39	1	4	102
HyPo	-m 10 -x -6 -g 0 -n 55 -q 17	random	inf	inf	inf	inf	inf
HyPo	-m 3 -x -7 -g -9 -n 24 -q 34	random	58	39	4	4	105
HyPo	-m 6 -x 0 -g -8 -n 15 -q 34	mutated	58	39	4	4	105
HyPo	-m 5 -x -3 -g 0 -n 57 -q 15	random	inf	inf	inf	inf	inf
HyPo	-m 6 -x 0 -g -8 -n 11 -q 41	mutated	58	39	1	4	102
HyPo	-m 5 -x -3 -g -4 -n 1 -q 56	random	59	39	1	4	103
HyPo	-m 6 -x 0 -g -7 -n 21 -q 38	mutated	58	39	4	4	105
HyPo	-m 6 -x -7 -g -4 -n 4 -q 54	random	60	42	6	4	112
HyPo	-m 6 -x 0 -g -7 -n 11 -q 41	mutated	58	39	1	4	102
HyPo	-m 7 -x -7 -g -4 -n 68 -q 55	random	60	42	6	4	112
HyPo	-m 7 -x -1 -g -7 -n 11 -q 31	mutated	58	39	4	4	105
HyPo	-m 6 -x -1 -g -9 -n 15 -q 34	random	58	39	4	4	105
HyPo	-m 6 -x -1 -g -7 -n 11 -q 41	mutated	58	39	1	4	102
HyPo	-m 4 -x -3 -g -8 -n 48 -q 27	random	58	39	4	4	105
HyPo	-m 5 -x -1 -g -8 -n 7 -q 39	mutated	58	39	4	4	105
HyPo	-m 0 -x -9 -g -7 -n 21 -q 19	random	60	39	4	4	107
HyPo	-m 7 -x -3 -g -1 -n 18 -q 52	random	72	52	8	4	136
HyPo	-m 6 -x -1 -g -8 -n 11 -q 45	mutated	58	40	1	4	103
HyPo	-m 3 -x -9 -g 0 -n 20 -q 23	random	inf	inf	inf	inf	inf
HyPo	-m 6 -x -1 -g -6 -n 11 -q 31	mutated	58	39	4	4	105
HyPo	-m 4 -x -8 -g -7 -n 70 -q 20	random	60	39	4	4	107
HyPo	-m 6 -x -2 -g -7 -n 11 -q 41	mutated	58	39	1	4	102
HyPo	-m 5 -x -1 -g -3 -n 21 -q 40	random	59	38	4	4	105
HyPo	-m 5 -x -2 -g -7 -n 3 -q 45	mutated	58	40	1	4	103
HyPo	-m 3 -x 0 -g -9 -n 4 -q 21	random	58	39	4	4	105
HyPo	-m 7 -x -2 -g -7 -n 11 -q 41	mutated	58	39	1	4	102
HyPo	-m 2 -x -3 -g -4 -n 15 -q 5	random	58	39	4	4	105
HyPo	-m 7 -x -1 -g -7 -n 11 -q 41	mutated	58	39	1	4	102
HyPo	-m 3 -x 0 -g -2 -n 62 -q 33	random	58	39	4	4	105
HyPo	-m 3 -x -3 -g 0 -n 28 -q 41	random	inf	inf	inf	inf	inf
HyPo	-m 7 -x -1 -g -8 -n 11 -q 41	mutated	58	39	1	4	102
HyPo	-m 4 -x -3 -g -1 -n 51 -q 40	random	72	51	10	4	137
HyPo	-m 7 -x -2 -g -8 -n 3 -q 41	mutated	58	39	1	4	102
HyPo	-m 1 -x -7 -g -10 -n 6 -q 51	random	58	40	1	4	103
HyPo	-m 6 -x -1 -g -6 -n 17 -q 23	random	58	39	4	4	105
HyPo	-m 8 -x -2 -g -8 -n 3 -q 41	mutated	58	39	1	4	102
HyPo	-m 5 -x 0 -g -9 -n 86 -q 29	random	58	39	4	4	105
HyPo	-m 0 -x -8 -g -1 -n 48 -q 37	random	74	45	8	4	131
HyPo	-m 3 -x -2 -g -5 -n 6 -q 43	random	58	40	1	4	103
HyPo	-m 8 -x -2 -g -9 -n 3 -q 41	mutated	58	39	1	4	102
HyPo	-m 10 -x -7 -g -7 -n 5 -q 22	random	59	38	6	4	107
HyPo	-m 8 -x -2 -g -9 -n 3 -q 45	mutated	58	40	1	4	103
HyPo	-m 7 -x -9 -g -7 -n 64 -q 7	random	60	40	4	4	108
HyPo	-m 8 -x -2 -g -9 -n 0 -q 41	mutated	58	39	1	4	102
HyPo	-m 4 -x -8 -g -5 -n 30 -q 44	random	60	41	1	4	106
HyPo	-m 7 -x -3 -g -9 -n 0 -q 41	mutated	58	39	1	4	102
HyPo	-m 2 -x -8 -g -8 -n 17 -q 20	random	59	38	4	4	105
HyPo	-m 7 -x -4 -g -9 -n 0 -q 41	mutated	58	39	1	4	102
HyPo	-m 6 -x -8 -g -5 -n 42 -q 58	random	60	41	3	4	108
HyPo	-m 6 -x -4 -g -8 -n 0 -q 47	mutated	58	40	1	4	103
HyPo	-m 0 -x -9 -g 0 -n 82 -q 24	random	inf	inf	inf	inf	inf
HyPo	-m 7 -x -4 -g -10 -n 0 -q 41	mutated	58	39	1	4	102
HyPo	-m 3 -x -1 -g -3 -n 33 -q 56	random	58	40	1	4	103
HyPo	-m 9 -x -10 -g -4 -n 66 -q 52	random	72	51	7	4	134
HyPo	-m 6 -x -4 -g -10 -n 0 -q 32	mutated	58	39	4	4	105
HyPo	-m 1 -x -2 -g -8 -n 4 -q 46	random	58	40	1	4	103
HyPo	-m 7 -x -5 -g -10 -n 0 -q 41	mutated	58	39	1	4	102
HyPo	-m 0 -x -10 -g -6 -n 1 -q 50	random	60	40	1	4	105
HyPo	-m 6 -x -6 -g -10 -n 0 -q 41	mutated	58	39	1	4	102
HyPo	-m 4 -x -5 -g -7 -n 0 -q 34	random	58	39	4	4	105
HyPo	-m 5 -x -6 -g -10 -n 0 -q 41	mutated	58	39	1	4	102
HyPo	-m 10 -x -10 -g -8 -n 5 -q 33	random	60	40	6	4	110
HyPo	-m 4 -x -6 -g -10 -n 0 -q 41	mutated	58	39	1	4	102
HyPo	-m 7 -x -1 -g -6 -n 45 -q 32	random	58	39	4	4	105
HyPo	-m 5 -x -7 -g -9 -n 0 -q 41	mutated	59	38	1	4	102
HyPo	-m 5 -x -6 -g -7 -n 16 -q 41	random	59	38	1	4	102
HyPo	-m 4 -x -6 -g -7 -n 16 -q 41	mutated	59	38	1	4	102
HyPo	-m 0 -x -5 -g -6 -n 71 -q 36	random	58	39	4	4	105
HyPo	-m 7 -x 0 -g -4 -n 0 -q 17	random	58	39	4	4	105
HyPo	-m 4 -x -6 -g -7 -n 16 -q 35	mutated	59	38	4	4	105
HyPo	-m 3 -x -5 -g -4 -n 14 -q 13	random	60	39	4	4	107
HyPo	-m 4 -x -6 -g -8 -n 25 -q 41	mutated	58	39	1	4	102
HyPo	-m 2 -x -5 -g -8 -n 57 -q 55	random	58	40	2	4	104
HyPo	-m 5 -x -6 -g -8 -n 25 -q 41	mutated	59	38	1	4	102
HyPo	-m 0 -x -10 -g -5 -n 31 -q 15	random	62	40	4	4	110
HyPo	-m 1 -x -4 -g -2 -n 64 -q 30	random	60	40	4	4	108
HyPo	-m 9 -x -3 -g -10 -n 55 -q 12	random	58	39	4	4	105
HyPo	-m 5 -x -6 -g -7 -n 25 -q 41	mutated	59	38	1	4	102
HyPo	-m 10 -x -10 -g -3 -n 5 -q 8	random	72	51	9	4	136
HyPo	-m 7 -x -7 -g 0 -n 36 -q 46	random	inf	inf	inf	inf	inf
HyPo	-m 6 -x -6 -g -7 -n 25 -q 41	mutated	59	38	1	4	102
HyPo	-m 0 -x -7 -g -4 -n 23 -q 11	random	60	39	4	4	107
HyPo	-m 5 -x -5 -g -7 -n 25 -q 41	mutated	59	38	1	4	102
HyPo	-m 1 -x -9 -g -2 -n 6 -q 17	random	72	46	8	4	130
HyPo	-m 4 -x -6 -g -7 -n 25 -q 41	mutated	59	38	1	4	102
HyPo	-m 10 -x -4 -g -3 -n 11 -q 41	random	60	44	3	4	111
HyPo	-m 4 -x -7 -g -7 -n 32 -q 34	mutated	59	38	4	4	105
HyPo	-m 0 -x -1 -g -1 -n 39 -q 41	random	58	40	1	4	103
HyPo	-m 4 -x -6 -g -7 -n 19 -q 41	mutated	59	38	1	4	102
HyPo	-m 1 -x -1 -g -8 -n 59 -q 37	random	58	39	4	4	105
HyPo	-m 4 -x -6 -g -7 -n 26 -q 41	mutated	59	38	1	4	102
HyPo	-m 1 -x 0 -g -3 -n 13 -q 16	random	58	39	4	4	105
HyPo	-m 4 -x -7 -g -7 -n 22 -q 41	mutated	59	38	1	4	102
HyPo	-m 0 -x -6 -g -8 -n 33 -q 60	random	58	40	1	4	103
HyPo	-m 4 -x -7 -g -7 -n 22 -q 51	mutated	59	39	4	4	106
HyPo	-m 6 -x -4 -g -5 -n 66 -q 45	random	59	39	1	4	103
HyPo	-m 4 -x -8 -g -6 -n 27 -q 41	mutated	60	39	1	4	104
HyPo	-m 3 -x -7 -g -6 -n 69 -q 34	random	60	39	4	4	107
HyPo	-m 4 -x -6 -g -6 -n 22 -q 41	mutated	59	38	1	4	102
HyPo	-m 6 -x -2 -g -2 -n 95 -q 26	random	59	42	6	4	111
HyPo	-m 4 -x -5 -g -6 -n 22 -q 41	mutated	59	38	1	4	102
HyPo	-m 4 -x -8 -g -4 -n 41 -q 25	random	60	40	4	4	108
HyPo	-m 4 -x -5 -g -5 -n 22 -q 41	mutated	59	38	1	4	102
HyPo	-m 3 -x -5 -g -8 -n 18 -q 42	random	58	40	1	4	103
HyPo	-m 8 -x -6 -g -3 -n 0 -q 11	random	60	44	6	4	114
HyPo	-m 6 -x -4 -g -8 -n 10 -q 14	random	58	39	4	4	105
HyPo	-m 4 -x -5 -g -5 -n 22 -q 48	mutated	59	39	1	4	103
HyPo	-m 9 -x -6 -g -8 -n 27 -q 21	random	59	38	4	4	105
HyPo	-m 4 -x -5 -g -5 -n 22 -q 33	mutated	59	38	4	4	105
HyPo	-m 8 -x -8 -g -8 -n 26 -q 31	random	59	38	4	4	105
HyPo	-m 4 -x -5 -g -5 -n 21 -q 41	mutated	59	38	1	4	102
HyPo	-m 3 -x -8 -g -8 -n 2 -q 7	random	59	38	4	4	105
HyPo	-m 4 -x -4 -g -4 -n 21 -q 32	mutated	59	38	4	4	105
HyPo	-m 4 -x -7 -g -9 -n 78 -q 0	random	58	41	1	4	104
HyPo	-m 4 -x -6 -g -5 -n 21 -q 41	mutated	60	39	1	4	104
HyPo	-m 6 -x -4 -g -8 -n 56 -q 45	random	58	40	1	4	103
HyPo	-m 3 -x -6 -g -5 -n 21 -q 41	mutated	60	39	1	4	104
HyPo	-m 7 -x 0 -g -7 -n 18 -q 32	random	58	39	4	4	105
HyPo	-m 4 -x -5 -g -5 -n 21 -q 36	mutated	59	38	4	4	105
HyPo	-m 10 -x 0 -g -6 -n 46 -q 44	random	58	40	1	4	103
HyPo	-m 5 -x -5 -g -5 -n 30 -q 41	mutated	59	38	1	4	102
HyPo	-m 0 -x -3 -g -9 -n 41 -q 28	random	58	39	4	4	105
HyPo	-m 2 -x -2 -g -9 -n 1 -q 19	random	58	39	4	4	105
HyPo	-m 5 -x -6 -g -4 -n 30 -q 41	mutated	60	40	3	4	107
HyPo	-m 5 -x -7 -g -8 -n 6 -q 54	random	59	39	4	4	106
HyPo	-m 8 -x -5 -g -6 -n 10 -q 19	random	59	38	6	4	107
HyPo	-m 6 -x -5 -g -6 -n 28 -q 41	mutated	59	38	1	4	102
HyPo	-m 5 -x -5 -g -2 -n 70 -q 49	random	72	51	6	4	133
HyPo	-m 0 -x -2 -g -6 -n 45 -q 40	random	58	39	4	4	105
HyPo	-m 5 -x -10 -g -3 -n 24 -q 13	random	72	47	9	4	132
HyPo	-m 6 -x -5 -g -7 -n 28 -q 41	mutated	59	38	1	4	102
HyPo	-m 8 -x -2 -g -5 -n 67 -q 29	random	59	38	4	4	105
HyPo	-m 6 -x -6 -g -8 -n 28 -q 35	mutated	59	38	4	4	105
HyPo	-m 4 -x -5 -g -1 -n 35 -q 54	random	72	52	7	4	135
HyPo	-m 6 -x -4 -g -7 -n 28 -q 31	mutated	58	39	4	4	105
HyPo	-m 5 -x -10 -g -9 -n 27 -q 57	random	60	40	1	4	105
HyPo	-m 5 -x -5 -g -7 -n 28 -q 41	mutated	59	38	1	4	102
HyPo	-m 9 -x -3 -g -9 -n 25 -q 22	random	58	39	4	4	105
HyPo	-m 5 -x -5 -g -7 -n 20 -q 41	mutated	59	38	1	4	102
HyPo	-m 5 -x -1 -g -7 -n 36 -q 26	random	58	39	4	4	105
HyPo	-m 5 -x -5 -g -8 -n 20 -q 41	mutated	58	39	1	4	102
HyPo	-m 3 -x -4 -g -4 -n 84 -q 5	random	59	38	4	4	105
HyPo	-m 5 -x -5 -g -8 -n 20 -q 32	mutated	58	39	4	4	105
HyPo	-m 6 -x -2 -g -3 -n 52 -q 55	random	59	39	4	4	106
HyPo	-m 4 -x -4 -g -9 -n 28 -q 41	mutated	58	39	1	4	102
HyPo	-m 3 -x -3 -g -5 -n 86 -q 37	random	58	39	4	4	105
HyPo	-m 5 -x -3 -g -10 -n 28 -q 41	mutated	58	39	1	4	102
HyPo	-m 6 -x -1 -g 0 -n 3 -q 22	random	inf	inf	inf	inf	inf
HyPo	-m 2 -x -2 -g -6 -n 0 -q 50	random	58	40	1	4	103
HyPo	-m 3 -x -10 -g -5 -n 69 -q 28	random	60	40	4	4	108
HyPo	-m 6 -x -4 -g -10 -n 28 -q 48	mutated	58	40	1	4	103
HyPo	-m 9 -x -6 -g -3 -n 44 -q 1	random	60	44	6	4	114
HyPo	-m 4 -x -3 -g -10 -n 28 -q 41	mutated	58	39	1	4	102
HyPo	-m 8 -x -6 -g -6 -n 32 -q 54	random	59	39	4	4	106
HyPo	-m 4 -x -2 -g -10 -n 31 -q 41	mutated	58	39	1	4	102
HyPo	-m 2 -x -5 -g -9 -n 0 -q 57	random	58	40	1	4	103
HyPo	-m 4 -x -1 -g -11 -n 31 -q 32	mutated	58	39	4	4	105
HyPo	-m 10 -x -9 -g -2 -n 22 -q 9	random	72	51	9	4	136
HyPo	-m 5 -x -3 -g -10 -n 31 -q 41	mutated	58	39	1	4	102
HyPo	-m 3 -x -8 -g -7 -n 0 -q 46	random	60	40	1	4	105
HyPo	-m 5 -x -2 -g -11 -n 31 -q 41	mutated	58	39	1	4	102
HyPo	-m 1 -x -1 -g -6 -n 0 -q 26	random	58	39	4	4	105
HyPo	-m 4 -x -2 -g -10 -n 39 -q 41	mutated	58	39	1	4	102
HyPo	-m 1 -x -6 -g -2 -n 18 -q 29	random	72	46	8	4	130
HyPo	-m 4 -x -2 -g -11 -n 31 -q 41	mutated	58	39	1	4	102
HyPo	-m 7 -x -9 -g -1 -n 23 -q 14	random	72	51	10	4	137
HyPo	-m 3 -x -8 -g -4 -n 18 -q 12	random	60	40	4	4	108
HyPo	-m 9 -x -5 -g -3 -n 91 -q 51	random	60	45	3	4	112
HyPo	-m 4 -x -2 -g -11 -n 39 -q 34	mutated	58	39	4	4	105
HyPo	-m 6 -x 0 -g -2 -n 6 -q 49	random	59	39	3	4	105
HyPo	-m 4 -x -1 -g -3 -n 1 -q 29	random	58	39	4	4	105
HyPo	-m 9 -x -4 -g -6 -n 16 -q 22	random	59	38	6	4	107
HyPo	-m 4 -x -2 -g -11 -n 25 -q 41	mutated	58	39	1	4	102
HyPo	-m 5 -x -9 -g -5 -n 80 -q 4	random	60	40	4	4	108
HyPo	-m 3 -x -2 -g -12 -n 17 -q 41	mutated	58	39	1	4	102
HyPo	-m 3 -x -8 -g -5 -n 1 -q 9	random	60	40	4	4	108
HyPo	-m 4 -x -2 -g -12 -n 11 -q 41	mutated	58	39	1	4	102
HyPo	-m 8 -x -10 -g -7 -n 53 -q 2	random	60	40	6	4	110
HyPo	-m 4 -x -2 -g -12 -n 14 -q 31	mutated	58	39	4	4	105
HyPo	-m 1 -x -3 -g -9 -n 9 -q 36	random	58	39	4	4	105
HyPo	-m 5 -x -2 -g -11 -n 11 -q 41	mutated	58	39	1	4	102
HyPo	-m 3 -x -5 -g -9 -n 13 -q 6	random	58	39	4	4	105
HyPo	-m 4 -x -2 -g -10 -n 11 -q 41	mutated	58	39	1	4	102
HyPo	-m 6 -x -4 -g -2 -n 20 -q 45	random	60	45	3	4	112
HyPo	-m 3 -x -9 -g -5 -n 53 -q 41	random	60	40	1	4	105
HyPo	-m 5 -x -2 -g -10 -n 11 -q 41	mutated	58	39	1	4	102
HyPo	-m 4 -x -1 -g -10 -n 21 -q 11	random	58	39	4	4	105
HyPo	-m 10 -x -4 -g -8 -n 23 -q 23	random	59	38	4	4	105
HyPo	-m 4 -x -3 -g -11 -n 11 -q 41	mutated	58	39	1	4	102
HyPo	-m 2 -x -4 -g -4 -n 9 -q 28	random	59	38	4	4	105
HyPo	-m 4 -x -1 -g -1 -n 15 -q 2	random	59	42	6	4	111
HyPo	-m 4 -x -3 -g -11 -n 11 -q 31	mutated	58	39	4	4	105
HyPo	-m 2 -x 0 -g -8 -n 78 -q 37	random	58	39	4	4	105
HyPo	-m 4 -x -3 -g -12 -n 2 -q 41	mutated	58	39	1	4	102
HyPo	-m 5 -x -10 -g -9 -n 41 -q 13	random	60	39	4	4	107
HyPo	-m 4 -x -3 -g -12 -n 2 -q 43	mutated	58	40	1	4	103
HyPo	-m 0 -x -5 -g -8 -n 53 -q 2	random	58	39	4	4	105
HyPo	-m 3 -x -1 -g -2 -n 28 -q 35	random	59	38	4	4	105
HyPo	-m 8 -x -1 -g 0 -n 6 -q 25	random	inf	inf	inf	inf	inf
HyPo	-m 3 -x -3 -g -11 -n 2 -q 48	mutated	58	40	1	4	103
HyPo	-m 2 -x -1 -g -1 -n 54 -q 49	random	59	39	3	4	105
HyPo	-m 4 -x -3 -g -11 -n 2 -q 41	mutated	58	39	1	4	102
HyPo	-m 3 -x -6 -g -3 -n 37 -q 25	random	60	40	4	4	108
HyPo	-m 4 -x -4 -g -11 -n 2 -q 41	mutated	58	39	1	4	102
HyPo	-m 10 -x 0 -g -4 -n 22 -q 36	random	59	38	6	4	107
HyPo	-m 10 -x -9 -g -1 -n 2 -q 35	random	77	53	10	4	144
HyPo	-m 5 -x -5 -g -9 -n 10 -q 23	random	58	39	4	4	105
HyPo	-m 4 -x -5 -g -11 -n 2 -q 41	mutated	58	39	1	4	102
HyPo	-m 9 -x 0 -g -3 -n 19 -q 60	random	59	39	3	4	105
HyPo	-m 4 -x -4 -g -7 -n 7 -q 31	random	58	39	4	4	105
HyPo	-m 4 -x -5 -g -11 -n 8 -q 41	mutated	58	39	1	4	102
HyPo	-m 10 -x -2 -g -5 -n 92 -q 24	random	59	38	6	4	107
HyPo	-m 4 -x -5 -g -11 -n 5 -q 41	mutated	58	39	1	4	102
HyPo	-m 7 -x -8 -g -7 -n 51 -q 17	random	60	40	4	4	108
HyPo	-m 1 -x -6 -g -3 -n 0 -q 19	random	60	40	4	4	108
HyPo	-m 4 -x -5 -g -11 -n 5 -q 38	mutated	58	39	4	4	105
HyPo	-m 0 -x -7 -g -1 -n 8 -q 58	random	74	46	5	4	129
HyPo	-m 3 -x -5 -g -11 -n 5 -q 44	mutated	58	40	1	4	103
HyPo	-m 4 -x -7 -g -6 -n 49 -q 38	random	60	39	4	4	107
HyPo	-m 3 -x -6 -g -11 -n 5 -q 41	mutated	58	39	1	4	102
HyPo	-m 1 -x -1 -g -1 -n 0 -q 19	random	59	38	4	4	105
HyPo	-m 4 -x -6 -g -11 -n 5 -q 41	mutated	58	39	1	4	102
HyPo	-m 6 -x -2 -g 0 -n 15 -q 28	random	inf	inf	inf	inf	inf
HyPo	-m 4 -x -6 -g -11 -n 12 -q 41	mutated	58	39	1	4	102
HyPo	-m 2 -x -10 -g -10 -n 60 -q 7	random	59	38	4	4	105
HyPo	-m 4 -x -5 -g -10 -n 12 -q 41	mutated	58	39	1	4	102
HyPo	-m 4 -x -9 -g -4 -n 7 -q 47	random	72	47	4	4	127
HyPo	-m 4 -x -5 -g -9 -n 12 -q 41	mutated	58	39	1	4	102
HyPo	-m 10 -x -7 -g 0 -n 13 -q 1	random	inf	inf	inf	inf	inf
HyPo	-m 5 -x -5 -g -9 -n 12 -q 41	mutated	58	39	1	4	102
HyPo	-m 7 -x -7 -g -9 -n 68 -q 56	random	59	39	1	4	103
HyPo	-m 9 -x 0 -g -2 -n 36 -q 15	random	59	42	6	4	111
HyPo	-m 6 -x -5 -g -9 -n 12 -q 41	mutated	58	39	1	4	102
HyPo	-m 0 -x -8 -g -9 -n 74 -q 26	random	58	39	4	4	105
HyPo	-m 6 -x -5 -g -10 -n 12 -q 41	mutated	58	39	1	4	102
HyPo	-m 4 -x -9 -g -2 -n 9 -q 8	random	72	47	9	4	132
HyPo	-m 5 -x -4 -g -10 -n 12 -q 41	mutated	58	39	1	4	102
HyPo	-m 2 -x -3 -g -7 -n 3 -q 55	random	58	40	2	4	104
HyPo	-m 4 -x -4 -g -10 -n 12 -q 41	mutated	58	39	1	4	102
HyPo	-m 6 -x -4 -g -6 -n 34 -q 16	random	59	38	4	4	105
HyPo	-m 9 -x -5 -g -9 -n 0 -q 10	random	59	38	4	4	105
HyPo	-m 4 -x -4 -g -10 -n 12 -q 39	mutated	58	39	4	4	105
HyPo	-m 5 -x -3 -g -6 -n 6 -q 23	random	58	39	4	4	105
HyPo	-m 4 -x -4 -g -11 -n 12 -q 41	mutated	58	39	1	4	102
HyPo	-m 0 -x -6 -g -7 -n 6 -q 16	random	58	39	4	4	105
HyPo	-m 5 -x -4 -g -11 -n 12 -q 41	mutated	58	39	1	4	102
HyPo	-m 9 -x -2 -g 0 -n 67 -q 42	random	inf	inf	inf	inf	inf
HyPo	-m 2 -x -8 -g -9 -n 52 -q 55	random	58	40	1	4	103
HyPo	-m 3 -x -6 -g -7 -n 32 -q 7	random	59	38	4	4	105
HyPo	-m 5 -x -4 -g -11 -n 12 -q 40	mutated	58	39	4	4	105
HyPo	-m 3 -x -9 -g -2 -n 3 -q 0	random	72	49	6	4	131
HyPo	-m 8 -x -10 -g -6 -n 3 -q 56	random	60	41	3	4	108
HyPo	-m 5 -x -4 -g -10 -n 12 -q 33	mutated	58	39	4	4	105
HyPo	-m 8 -x -9 -g -1 -n 53 -q 56	random	72	52	7	4	135
HyPo	-m 5 -x -4 -g -12 -n 12 -q 41	mutated	58	39	1	4	102
HyPo	-m 10 -x -8 -g -6 -n 0 -q 22	random	60	40	6	4	110
HyPo	-m 5 -x -4 -g -12 -n 12 -q 33	mutated	58	39	4	4	105
HyPo	-m 3 -x -9 -g -8 -n 98 -q 54	random	60	40	1	4	105
HyPo	-m 7 -x -5 -g -1 -n 31 -q 18	random	72	51	10	4	137
HyPo	-m 5 -x -4 -g -12 -n 11 -q 41	mutated	58	39	1	4	102
HyPo	-m 6 -x -3 -g -8 -n 12 -q 21	random	58	39	4	4	105
HyPo	-m 6 -x -5 -g -13 -n 11 -q 48	mutated	58	40	1	4	103
HyPo	-m 1 -x -10 -g -8 -n 0 -q 53	random	60	40	1	4	105
HyPo	-m 5 -x -3 -g -12 -n 11 -q 41	mutated	58	39	1	4	102
HyPo	-m 2 -x -1 -g -10 -n 6 -q 36	random	58	39	4	4	105
HyPo	-m 6 -x 0 -g -1 -n 42 -q 19	random	59	43	6	4	112
HyPo	-m 5 -x -3 -g -12 -n 11 -q 48	mutated	58	40	1	4	103
HyPo	-m 3 -x -5 -g -5 -n 0 -q 37	random	59	38	4	4	105
HyPo	-m 10 -x -5 -g -7 -n 21 -q 54	random	59	39	4	4	106
HyPo	-m 5 -x -3 -g -13 -n 11 -q 41	mutated	58	39	1	4	102
HyPo	-m 7 -x -6 -g -7 -n 8 -q 10	random	59	38	4	4	105
HyPo	-m 5 -x -3 -g -13 -n 11 -q 32	mutated	58	39	4	4	105
HyPo	-m 6 -x -5 -g -7 -n 15 -q 36	random	59	38	4	4	105
HyPo	-m 6 -x -3 -g -6 -n 15 -q 9	random	58	39	4	4	105
HyPo	-m 6 -x -2 -g -13 -n 13 -q 41	mutated	58	39	1	4	102
HyPo	-m 6 -x -4 -g -7 -n 22 -q 2	random	58	39	4	4	105
HyPo	-m 9 -x -9 -g -7 -n 13 -q 22	random	60	40	6	4	110
HyPo	-m 6 -x -2 -g -13 -n 17 -q 41	mutated	58	39	1	4	102
HyPo	-m 8 -x -8 -g 0 -n 14 -q 17	random	inf	inf	inf	inf	inf
HyPo	-m 6 -x -2 -g -13 -n 24 -q 41	mutated	58	39	1	4	102
HyPo	-m 1 -x 0 -g -7 -n 21 -q 48	random	58	40	1	4	103
HyPo	-m 7 -x -2 -g -13 -n 29 -q 41	mutated	58	39	1	4	102
HyPo	-m 9 -x -1 -g -1 -n 2 -q 2	random	60	44	6	4	114
HyPo	-m 2 -x -3 -g -6 -n 88 -q 38	random	58	39	4	4	105
HyPo	-m 4 -x -6 -g -10 -n 1 -q 3	random	58	39	4	4	105
HyPo	-m 7 -x -2 -g -14 -n 29 -q 41	mutated	58	39	1	4	102
HyPo	-m 0 -x -1 -g -10 -n 16 -q 19	random	58	39	4	4	105
HyPo	-m 3 -x -4 -g -2 -n 13 -q 29	random	60	41	6	4	111
HyPo	-m 8 -x -2 -g -14 -n 29 -q 41	mutated	58	39	1	4	102
HyPo	-m 5 -x -9 -g -5 -n 44 -q 13	random	60	40	4	4	108
HyPo	-m 8 -x -2 -g -14 -n 35 -q 41	mutated	58	39	1	4	102
HyPo	-m 8 -x -2 -g 0 -n 1 -q 15	random	inf	inf	inf	inf	inf
HyPo	-m 5 -x -8 -g -5 -n 35 -q 34	random	60	40	4	4	108
HyPo	-m 6 -x 0 -g -7 -n 7 -q 46	random	58	40	1	4	103
HyPo	-m 8 -x -2 -g -14 -n 35 -q 42	mutated	58	40	1	4	103
HyPo	-m 1 -x -5 -g 0 -n 99 -q 13	random	inf	inf	inf	inf	inf
HyPo	-m 4 -x -10 -g -10 -n 4 -q 29	random	59	38	4	4	105
HyPo	-m 9 -x -2 -g -14 -n 35 -q 34	mutated	58	39	4	4	105
HyPo	-m 0 -x -6 -g -4 -n 80 -q 60	random	60	40	1	4	105
HyPo	-m 8 -x -2 -g -14 -n 33 -q 51	mutated	58	40	2	4	104
HyPo	-m 0 -x -10 -g -9 -n 83 -q 41	random	60	39	1	4	104
HyPo	-m 2 -x -4 -g -3 -n 80 -q 11	random	60	39	4	4	107
HyPo	-m 9 -x -2 -g -15 -n 35 -q 46	mutated	58	40	1	4	103
HyPo	-m 1 -x -9 -g -10 -n 61 -q 48	random	58	40	1	4	103
HyPo	-m 8 -x -3 -g -14 -n 25 -q 41	mutated	58	39	1	4	102
HyPo	-m 5 -x -5 -g -6 -n 58 -q 13	random	59	38	4	4	105
HyPo	-m 8 -x -3 -g -14 -n 19 -q 41	mutated	58	39	1	4	102
HyPo	-m 2 -x -10 -g -10 -n 0 -q 8	random	59	38	4	4	105
HyPo	-m 8 -x -2 -g -14 -n 19 -q 33	mutated	58	39	4	4	105
HyPo	-m 8 -x -7 -g -1 -n 3 -q 44	random	72	52	6	4	134
HyPo	-m 5 -x -5 -g -3 -n 81 -q 48	random	60	42	3	4	109
HyPo	-m 8 -x -3 -g -15 -n 19 -q 41	mutated	58	39	1	4	102
HyPo	-m 7 -x -8 -g -1 -n 20 -q 3	random	72	51	9	4	136
HyPo	-m 8 -x -3 -g -16 -n 19 -q 41	mutated	58	39	1	4	102
HyPo	-m 6 -x 0 -g -1 -n 11 -q 54	random	59	44	4	4	111
HyPo	-m 8 -x -3 -g -16 -n 12 -q 39	mutated	58	39	4	4	105
HyPo	-m 9 -x -9 -g -8 -n 17 -q 22	random	60	40	6	4	110
HyPo	-m 9 -x -3 -g -16 -n 21 -q 41	mutated	58	39	1	4	102
HyPo	-m 4 -x -1 -g -1 -n 15 -q 50	random	59	43	3	4	109
HyPo	-m 10 -x -3 -g -15 -n 21 -q 41	mutated	58	39	1	4	102
HyPo	-m 10 -x -9 -g -10 -n 11 -q 21	random	59	38	4	4	105
HyPo	-m 4 -x -2 -g -5 -n 16 -q 52	random	58	40	2	4	104
HyPo	-m 10 -x -2 -g -15 -n 21 -q 41	mutated	58	39	1	4	102
HyPo	-m 6 -x -8 -g -7 -n 0 -q 13	random	60	39	4	4	107
HyPo	-m 9 -x -2 -g -15 -n 26 -q 49	mutated	58	40	1	4	103
HyPo	-m 6 -x -9 -g -5 -n 89 -q 15	random	60	40	6	4	110
HyPo	-m 9 -x -2 -g -15 -n 31 -q 51	mutated	58	40	2	4	104
HyPo	-m 8 -x -1 -g -5 -n 2 -q 29	random	58	39	4	4	105
HyPo	-m 10 -x -2 -g -15 -n 31 -q 41	mutated	58	39	1	4	102
HyPo	-m 0 -x -10 -g -8 -n 4 -q 33	random	60	39	4	4	107
HyPo	-m 7 -x -7 -g -9 -n 43 -q 11	random	59	38	4	4	105
HyPo	-m 9 -x -2 -g -15 -n 31 -q 41	mutated	58	39	1	4	102
HyPo	-m 8 -x -6 -g -3 -n 64 -q 7	random	60	44	6	4	114
HyPo	-m 9 -x -2 -g -16 -n 31 -q 41	mutated	58	39	1	4	102
HyPo	-m 5 -x -1 -g -1 -n 53 -q 27	random	59	43	6	4	112
HyPo	-m 8 -x -2 -g -17 -n 31 -q 41	mutated	58	39	1	4	102
HyPo	-m 9 -x -2 -g -10 -n 92 -q 17	random	58	39	4	4	105
HyPo	-m 7 -x -1 -g -16 -n 31 -q 41	mutated	58	39	1	4	102
HyPo	-m 4 -x -10 -g -3 -n 24 -q 31	random	72	47	10	4	133
HyPo	-m 5 -x -4 -g -1 -n 85 -q 10	random	72	51	9	4	136
HyPo	-m 7 -x 0 -g -16 -n 31 -q 41	mutated	58	39	1	4	102
HyPo	-m 1 -x -2 -g -4 -n 14 -q 38	random	58	39	4	4	105
HyPo	-m 7 -x 0 -g -15 -n 31 -q 41	mutated	58	39	1	4	102
HyPo	-m 5 -x -4 -g -10 -n 19 -q 38	random	58	39	4	4	105
HyPo	-m 7 -x 0 -g -15 -n 29 -q 35	mutated	58	39	4	4	105
HyPo	-m 5 -x -3 -g -7 -n 8 -q 42	random	58	40	1	4	103
HyPo	-m 7 -x 0 -g -15 -n 24 -q 48	mutated	58	40	1	4	103
HyPo	-m 2 -x -4 -g -5 -n 35 -q 19	random	58	39	4	4	105
HyPo	-m 6 -x 0 -g -15 -n 31 -q 41	mutated	58	39	1	4	102
HyPo	-m 7 -x -7 -g -4 -n 39 -q 58	random	60	42	3	4	109
HyPo	-m 0 -x -9 -g 0 -n 1 -q 12	random	inf	inf	inf	inf	inf
HyPo	-m 5 -x 0 -g -15 -n 31 -q 41	mutated	58	39	1	4	102
HyPo	-m 1 -x 0 -g 0 -n 76 -q 49	random	inf	inf	inf	inf	inf
HyPo	-m 0 -x -4 -g -8 -n 32 -q 47	random	58	40	1	4	103
HyPo	-m 5 -x -1 -g -15 -n 29 -q 49	mutated	58	40	1	4	103
HyPo	-m 3 -x -3 -g -2 -n 26 -q 23	random	60	40	6	4	110
HyPo	-m 5 -x 0 -g -15 -n 31 -q 37	mutated	58	39	4	4	105
HyPo	-m 1 -x -6 -g -4 -n 95 -q 60	random	60	40	1	4	105
HyPo	-m 4 -x 0 -g -9 -n 78 -q 48	random	58	40	1	4	103
HyPo	-m 1 -x 0 -g -6 -n 61 -q 60	random	58	40	1	4	103
HyPo	-m 4 -x -7 -g -9 -n 65 -q 6	random	58	39	4	4	105
HyPo	-m 5 -x -1 -g -2 -n 10 -q 2	random	59	38	6	4	107
HyPo	-m 1 -x -9 -g -4 -n 69 -q 22	random	72	46	8	4	130
HyPo	-m 8 -x -9 -g -8 -n 63 -q 23	random	60	40	4	4	108
HyPo	-m 4 -x 0 -g -15 -n 24 -q 41	mutated	58	39	1	4	102
HyPo	-m 4 -x -5 -g -8 -n 44 -q 31	random	58	39	4	4	105
HyPo	-m 10 -x -9 -g -4 -n 43 -q 3	random	72	50	9	4	135
HyPo	-m 8 -x -3 -g -9 -n 41 -q 0	random	58	41	1	4	104
HyPo	-m 4 -x -1 -g -15 -n 24 -q 41	mutated	58	39	1	4	102
HyPo	-m 5 -x -6 -g -1 -n 39 -q 55	random	72	52	7	4	135
HyPo	-m 4 -x -1 -g -14 -n 24 -q 41	mutated	58	39	1	4	102
HyPo	-m 2 -x -6 -g -5 -n 22 -q 33	random	60	39	4	4	107
HyPo	-m 4 -x -2 -g -14 -n 24 -q 41	mutated	58	39	1	4	102
HyPo	-m 8 -x -3 -g -8 -n 70 -q 53	random	58	40	2	4	104
HyPo	-m 2 -x -4 -g -4 -n 97 -q 9	random	59	38	4	4	105
HyPo	-m 4 -x -3 -g -14 -n 24 -q 36	mutated	58	39	4	4	105
HyPo	-m 0 -x -8 -g -1 -n 73 -q 53	random	74	46	5	4	129
HyPo	-m 4 -x -2 -g -14 -n 27 -q 36	mutated	58	39	4	4	105
HyPo	-m 6 -x -1 -g -5 -n 22 -q 3	random	58	39	4	4	105
HyPo	-m 4 -x -2 -g -13 -n 23 -q 48	mutated	58	40	1	4	103
HyPo	-m 9 -x -1 -g -3 -n 29 -q 43	random	59	43	3	4	109
HyPo	-m 1 -x 0 -g -7 -n 27 -q 51	random	58	40	1	4	103
HyPo	-m 6 -x -10 -g 0 -n 39 -q 57	random	inf	inf	inf	inf	inf
HyPo	-m 3 -x -8 -g -7 -n 18 -q 55	random	60	40	1	4	105
HyPo	-m 4 -x -2 -g -13 -n 24 -q 41	mutated	58	39	1	4	102
HyPo	-m 10 -x -1 -g -9 -n 1 -q 39	random	58	39	4	4	105
HyPo	-m 0 -x -1 -g -8 -n 59 -q 22	random	58	39	4	4	105
HyPo	-m 4 -x -3 -g -12 -n 24 -q 47	mutated	58	40	1	4	103
HyPo	-m 10 -x -2 -g -8 -n 3 -q 50	random	58	40	1	4	103
HyPo	-m 4 -x -1 -g -13 -n 24 -q 41	mutated	58	39	1	4	102
HyPo	-m 4 -x -6 -g -3 -n 25 -q 52	random	60	42	6	4	112
HyPo	-m 4 -x -1 -g -12 -n 24 -q 36	mutated	58	39	4	4	105
HyPo	-m 6 -x -6 -g 0 -n 14 -q 20	random	inf	inf	inf	inf	inf
HyPo	-m 5 -x -1 -g -13 -n 24 -q 41	mutated	58	39	1	4	102
HyPo	-m 9 -x -2 -g -7 -n 83 -q 4	random	58	39	4	4	105
HyPo	-m 1 -x -6 -g -5 -n 86 -q 39	random	60	39	4	4	107
HyPo	-m 5 -x 0 -g -13 -n 24 -q 41	mutated	58	39	1	4	102
HyPo	-m 10 -x -4 -g -7 -n 57 -q 21	random	59	38	4	4	105
HyPo	-m 5 -x 0 -g -13 -n 16 -q 41	mutated	58	39	1	4	102
HyPo	-m 10 -x -3 -g -2 -n 26 -q 51	random	61	47	3	4	115
HyPo	-m 5 -x -1 -g -13 -n 16 -q 41	mutated	58	39	1	4	102
HyPo	-m 7 -x -5 -g -5 -n 6 -q 10	random	59	38	6	4	107
HyPo	-m 6 -x -1 -g -13 -n 24 -q 36	mutated	58	39	4	4	105
HyPo	-m 2 -x -4 -g -6 -n 43 -q 14	random	58	39	4	4	105
HyPo	-m 6 -x -1 -g -13 -n 16 -q 41	mutated	58	39	1	4	102
HyPo	-m 10 -x -3 -g -2 -n 98 -q 46	random	61	47	3	4	115
HyPo	-m 4 -x 0 -g 0 -n 45 -q 34	random	inf	inf	inf	inf	inf
HyPo	-m 6 -x 0 -g -13 -n 16 -q 41	mutated	58	39	1	4	102
HyPo	-m 10 -x -9 -g -9 -n 24 -q 7	random	59	38	6	4	107
HyPo	-m 7 -x -1 -g -13 -n 16 -q 41	mutated	58	39	1	4	102
HyPo	-m 4 -x -10 -g -1 -n 33 -q 20	random	72	51	10	4	137
HyPo	-m 7 -x -1 -g -13 -n 23 -q 41	mutated	58	39	1	4	102
HyPo	-m 4 -x -4 -g -8 -n 3 -q 7	random	58	39	4	4	105
HyPo	-m 7 -x -1 -g -12 -n 23 -q 41	mutated	58	39	1	4	102
HyPo	-m 2 -x -4 -g 0 -n 0 -q 56	random	inf	inf	inf	inf	inf
HyPo	-m 3 -x -4 -g -1 -n 98 -q 9	random	72	50	9	4	135
HyPo	-m 8 -x -4 -g 0 -n 24 -q 39	random	inf	inf	inf	inf	inf
HyPo	-m 6 -x -1 -g -11 -n 23 -q 41	mutated	58	39	1	4	102
HyPo	-m 7 -x -9 -g -4 -n 20 -q 35	random	72	47	10	4	133
HyPo	-m 6 -x 0 -g -11 -n 30 -q 41	mutated	58	39	1	4	102
HyPo	-m 4 -x -6 -g -4 -n 92 -q 8	random	60	40	4	4	108
HyPo	-m 7 -x 0 -g -11 -n 30 -q 41	mutated	58	39	1	4	102
HyPo	-m 2 -x -5 -g -9 -n 25 -q 5	random	58	39	4	4	105
HyPo	-m 3 -x -10 -g -5 -n 27 -q 26	random	60	40	4	4	108
HyPo	-m 7 -x -1 -g -11 -n 30 -q 41	mutated	58	39	1	4	102
HyPo	-m 0 -x -10 -g -4 -n 1 -q 58	random	74	46	5	4	129
HyPo	-m 10 -x -1 -g -5 -n 10 -q 39	random	59	38	6	4	107
HyPo	-m 7 -x -2 -g -11 -n 30 -q 41	mutated	58	39	1	4	102
HyPo	-m 10 -x -2 -g -6 -n 63 -q 0	random	59	40	1	4	104
HyPo	-m 6 -x -10 -g -2 -n 46 -q 31	random	72	50	10	4	136
HyPo	-m 7 -x -3 -g -11 -n 30 -q 41	mutated	58	39	1	4	102
HyPo	-m 2 -x -6 -g -7 -n 66 -q 57	random	58	40	1	4	103
HyPo	-m 10 -x -1 -g -9 -n 6 -q 17	random	58	39	4	4	105
HyPo	-m 0 -x -10 -g -10 -n 27 -q 8	random	58	40	4	4	106
HyPo	-m 0 -x -9 -g -8 -n 8 -q 26	random	60	39	4	4	107
HyPo	-m 6 -x -4 -g -11 -n 30 -q 41	mutated	58	39	1	4	102
HyPo	-m 0 -x -3 -g -5 -n 0 -q 25	random	58	39	4	4	105
HyPo	-m 6 -x -4 -g -12 -n 30 -q 41	mutated	58	39	1	4	102
HyPo	-m 9 -x 0 -g -3 -n 0 -q 7	random	59	38	6	4	107
HyPo	-m 6 -x -4 -g -12 -n 39 -q 41	mutated	58	39	1	4	102
NextPolish	-min_map_quality 0 -max_ins_fold_sgs 5 -max_clip_ratio_sgs 0.15 -trim_len_edge 2 -ext_len_edge 2 -indel_balance_factor_sgs 0.5 -min_count_ratio_skip 0.8 -max_len_kmer 50 -min_len_inter_kmer 5 -max_count_kmer 50	defaults	879	63	18	0	960
NextPolish	-min_map_quality 47 -max_ins_fold_sgs 13 -max_clip_ratio_sgs 0.09 -trim_len_edge 19 -ext_len_edge 11 -indel_balance_factor_sgs 0.28 -min_count_ratio_skip 0.85 -max_len_kmer 59 -min_len_inter_kmer 3 -max_count_kmer 19	random	904	82	22	5	1013
NextPolish	-min_map_quality 0 -max_ins_fold_sgs 5 -max_clip_ratio_sgs 0.15 -trim_len_edge 2 -ext_len_edge 1 -indel_balance_factor_sgs 0.5 -min_count_ratio_skip 0.8 -max_len_kmer 50 -min_len_inter_kmer 5 -max_count_kmer 50	mutated	879	63	18	0	960
NextPolish	-min_map_quality 8 -max_ins_fold_sgs 5 -max_clip_ratio_sgs 0.0 -trim_len_edge 0 -ext_len_edge 18 -indel_balance_factor_sgs 0.35 -min_count_ratio_skip 0.38 -max_len_kmer 39 -min_len_inter_kmer 3 -max_count_kmer 98	random	569	24	8	0	601
NextPolish	-min_map_quality 8 -max_ins_fold_sgs 5 -max_clip_ratio_sgs 0.0 -trim_len_edge 0 -ext_len_edge 18 -indel_balance_factor_sgs 0.42 -min_count_ratio_skip 0.38 -max_len_kmer 39 -min_len_inter_kmer 3 -max_count_kmer 98	mutated	569	24	8	0	601
NextPolish	-min_map_quality 56 -max_ins_fold_sgs 6 -max_clip_ratio_sgs 0.19 -trim_len_edge 1 -ext_len_edge 0 -indel_balance_factor_sgs 0.25 -min_count_ratio_skip 0.85 -max_len_kmer 52 -min_len_inter_kmer 7 -max_count_kmer 24	random	931	78	21	3	1033
NextPolish	-min_map_quality 8 -max_ins_fold_sgs 5 -max_clip_ratio_sgs 0.0 -trim_len_edge 0 -ext_len_edge 18 -indel_balance_factor_sgs 0.42 -min_count_ratio_skip 0.38 -max_len_kmer 39 -min_len_inter_kmer 3 -max_count_kmer 92	mutated	569	24	8	0	601
NextPolish	-min_map_quality 28 -max_ins_fold_sgs 3 -max_clip_ratio_sgs 0.84 -trim_len_edge 15 -ext_len_edge 1 -indel_balance_factor_sgs 0.62 -min_count_ratio_skip 0.81 -max_len_kmer 37 -min_len_inter_kmer 2 -max_count_kmer 33	random	902	82	18	3	1005
NextPolish	-min_map_quality 37 -max_ins_fold_sgs 7 -max_clip_ratio_sgs 0.01 -trim_len_edge 1 -ext_len_edge 1 -indel_balance_factor_sgs 0.98 -min_count_ratio_skip 0.83 -max_len_kmer 25 -min_len_inter_kmer 10 -max_count_kmer 63	random	910	71	20	0	1001
NextPolish	-min_map_quality 25 -max_ins_fold_sgs 4 -max_clip_ratio_sgs 0.49 -trim_len_edge 18 -ext_len_edge 1 -indel_balance_factor_sgs 0.24 -min_count_ratio_skip 0.76 -max_len_kmer 84 -min_len_inter_kmer 9 -max_count_kmer 59	random	901	79	21	5	1006
NextPolish	-min_map_quality 16 -max_ins_fold_sgs 5 -max_clip_ratio_sgs 0.0 -trim_len_edge 0 -ext_len_edge 20 -indel_balance_factor_sgs 0.42 -min_count_ratio_skip 0.35 -max_len_kmer 39 -min_len_inter_kmer 3 -max_count_kmer 92	mutated	569	24	8	0	601
NextPolish	-min_map_quality 37 -max_ins_fold_sgs 3 -max_clip_ratio_sgs 0.0 -trim_len_edge 1 -ext_len_edge 0 -indel_balance_factor_sgs 0.11 -min_count_ratio_skip 0.76 -max_len_kmer 73 -min_len_inter_kmer 6 -max_count_kmer 28	random	870	62	17	0	949
NextPolish	-min_map_quality 9 -max_ins_fold_sgs 16 -max_clip_ratio_sgs 0.03 -trim_len_edge 14 -ext_len_edge 12 -indel_balance_factor_sgs 0.35 -min_count_ratio_skip 0.67 -max_len_kmer 55 -min_len_inter_kmer 5 -max_count_kmer 25	random	854	73	19	0	946
NextPolish	-min_map_quality 16 -max_ins_fold_sgs 5 -max_clip_ratio_sgs 0.02 -trim_len_edge 0 -ext_len_edge 20 -indel_balance_factor_sgs 0.41 -min_count_ratio_skip 0.33 -max_len_kmer 39 -min_len_inter_kmer 3 -max_count_kmer 92	mutated	564	24	8	0	596
NextPolish	-min_map_quality 45 -max_ins_fold_sgs 1 -max_clip_ratio_sgs 0.86 -trim_len_edge 0 -ext_len_edge 0 -indel_balance_factor_sgs 0.98 -min_count_ratio_skip 0.18 -max_len_kmer 86 -min_len_inter_kmer 7 -max_count_kmer 88	random	566	24	8	0	598
NextPolish	-min_map_quality 58 -max_ins_fold_sgs 13 -max_clip_ratio_sgs 0.04 -trim_len_edge 0 -ext_len_edge 2 -indel_balance_factor_sgs 0.26 -min_count_ratio_skip 0.92 -max_len_kmer 73 -min_len_inter_kmer 5 -max_count_kmer 4	random	957	91	22	3	1073
NextPolish	-min_map_quality 16 -max_ins_fold_sgs 5 -max_clip_ratio_sgs 0.02 -trim_len_edge 0 -ext_len_edge 20 -indel_balance_factor_sgs 0.41 -min_count_ratio_skip 0.33 -max_len_kmer 31 -min_len_inter_kmer 3 -max_count_kmer 92	mutated	564	24	8	0	596
NextPolish	-min_map_quality 53 -max_ins_fold_sgs 1 -max_clip_ratio_sgs 0.27 -trim_len_edge 20 -ext_len_edge 3 -indel_balance_factor_sgs 0.4 -min_count_ratio_skip 0.69 -max_len_kmer 35 -min_len_inter_kmer 7 -max_count_kmer 15	random	867	71	22	1	961
NextPolish	-min_map_quality 16 -max_ins_fold_sgs 5 -max_clip_ratio_sgs 0.02 -trim_len_edge 0 -ext_len_edge 20 -indel_balance_factor_sgs 0.36 -min_count_ratio_skip 0.33 -max_len_kmer 30 -min_len_inter_kmer 3 -max_count_kmer 92	mutated	564	24	8	0	596
NextPolish	-min_map_quality 39 -max_ins_fold_sgs 1 -max_clip_ratio_sgs 0.02 -trim_len_edge 4 -ext_len_edge 6 -indel_balance_factor_sgs 0.36 -min_count_ratio_skip 0.8 -max_len_kmer 41 -min_len_inter_kmer 6 -max_count_kmer 57	random	896	68	23	0	987
NextPolish	-min_map_quality 16 -max_ins_fold_sgs 5 -max_clip_ratio_sgs 0.0 -trim_len_edge 0 -ext_len_edge 20 -indel_balance_factor_sgs 0.36 -min_count_ratio_skip 0.33 -max_len_kmer 30 -min_len_inter_kmer 3 -max_count_kmer 92	mutated	564	24	8	0	596
NextPolish	-min_map_quality 3 -max_ins_fold_sgs 15 -max_clip_ratio_sgs 0.65 -trim_len_edge 2 -ext_len_edge 8 -indel_balance_factor_sgs 0.44 -min_count_ratio_skip 0.95 -max_len_kmer 93 -min_len_inter_kmer 10 -max_count_kmer 89	random	945	89	21	3	1058
NextPolish	-min_map_quality 7 -max_ins_fold_sgs 5 -max_clip_ratio_sgs 0.0 -trim_len_edge 0 -ext_len_edge 20 -indel_balance_factor_sgs 0.36 -min_count_ratio_skip 0.33 -max_len_kmer 30 -min_len_inter_kmer 3 -max_count_kmer 92	mutated	564	24	8	0	596
NextPolish	-min_map_quality 47 -max_ins_fold_sgs 3 -max_clip_ratio_sgs 0.04 -trim_len_edge 10 -ext_len_edge 21 -indel_balance_factor_sgs 0.79 -min_count_ratio_skip 0.91 -max_len_kmer 28 -min_len_inter_kmer 2 -max_count_kmer 29	random	917	80	19	3	1019
NextPolish	-min_map_quality 8 -max_ins_fold_sgs 14 -max_clip_ratio_sgs 0.08 -trim_len_edge 7 -ext_len_edge 6 -indel_balance_factor_sgs 0.79 -min_count_ratio_skip 0.74 -max_len_kmer 14 -min_len_inter_kmer 7 -max_count_kmer 81	random	857	59	21	0	937
NextPolish	-min_map_quality 7 -max_ins_fold_sgs 5 -max_clip_ratio_sgs 0.0 -trim_len_edge 2 -ext_len_edge 20 -indel_balance_factor_sgs 0.4 -min_count_ratio_skip 0.33 -max_len_kmer 30 -min_len_inter_kmer 3 -max_count_kmer 92	mutated	602	25	11	0	638
NextPolish	-min_map_quality 26 -max_ins_fold_sgs 3 -max_clip_ratio_sgs 0.29 -trim_len_edge 2 -ext_len_edge 2 -indel_balance_factor_sgs 0.12 -min_count_ratio_skip 0.41 -max_len_kmer 91 -min_len_inter_kmer 4 -max_count_kmer 80	random	603	25	11	0	639
NextPolish	-min_map_quality 6 -max_ins_fold_sgs 4 -max_clip_ratio_sgs 0.0 -trim_len_edge 0 -ext_len_edge 20 -indel_balance_factor_sgs 0.29 -min_count_ratio_skip 0.33 -max_len_kmer 30 -min_len_inter_kmer 2 -max_count_kmer 92	mutated	564	24	8	0	596
NextPolish	-min_map_quality 49 -max_ins_fold_sgs 8 -max_clip_ratio_sgs 0.1 -trim_len_edge 17 -ext_len_edge 10 -indel_balance_factor_sgs 0.29 -min_count_ratio_skip 0.63 -max_len_kmer 41 -min_len_inter_kmer 9 -max_count_kmer 68	random	745	57	14	1	817
NextPolish	-min_map_quality 5 -max_ins_fold_sgs 4 -max_clip_ratio_sgs 0.0 -trim_len_edge 0 -ext_len_edge 19 -indel_balance_factor_sgs 0.29 -min_count_ratio_skip 0.33 -max_len_kmer 30 -min_len_inter_kmer 1 -max_count_kmer 92	mutated	564	24	8	0	596
NextPolish	-min_map_quality 7 -max_ins_fold_sgs 8 -max_clip_ratio_sgs 0.14 -trim_len_edge 0 -ext_len_edge 1 -indel_balance_factor_sgs 0.56 -min_count_ratio_skip 0.84 -max_len_kmer 40 -min_len_inter_kmer 7 -max_count_kmer 16	random	936	78	20	3	1037
NextPolish	-min_map_quality 5 -max_ins_fold_sgs 4 -max_clip_ratio_sgs 0.0 -trim_len_edge 1 -ext_len_edge 19 -indel_balance_factor_sgs 0.29 -min_count_ratio_skip 0.33 -max_len_kmer 30 -min_len_inter_kmer 1 -max_count_kmer 90	mutated	586	23	9	0	618
NextPolish	-min_map_quality 23 -max_ins_fold_sgs 4 -max_clip_ratio_sgs 0.09 -trim_len_edge 18 -ext_len_edge 21 -indel_balance_factor_sgs 0.24 -min_count_ratio_skip 0.94 -max_len_kmer 92 -min_len_inter_kmer 10 -max_count_kmer 55	random	915	82	21	5	1023
NextPolish	-min_map_quality 5 -max_ins_fold_sgs 4 -max_clip_ratio_sgs 0.08 -trim_len_edge 0 -ext_len_edge 21 -indel_balance_factor_sgs 0.29 -min_count_ratio_skip 0.33 -max_len_kmer 30 -min_len_inter_kmer 1 -max_count_kmer 92	mutated	564	24	8	0	596
NextPolish	-min_map_quality 5 -max_ins_fold_sgs 1 -max_clip_ratio_sgs 0.89 -trim_len_edge 11 -ext_len_edge 16 -indel_balance_factor_sgs 0.73 -min_count_ratio_skip 0.96 -max_len_kmer 42 -min_len_inter_kmer 4 -max_count_kmer 75	random	913	76	20	3	1012
NextPolish	-min_map_quality 3 -max_ins_fold_sgs 4 -max_clip_ratio_sgs 0.16 -trim_len_edge 0 -ext_len_edge 21 -indel_balance_factor_sgs 0.29 -min_count_ratio_skip 0.33 -max_len_kmer 30 -min_len_inter_kmer 1 -max_count_kmer 97	mutated	564	24	8	0	596
NextPolish	-min_map_quality 11 -max_ins_fold_sgs 3 -max_clip_ratio_sgs 0.0 -trim_len_edge 0 -ext_len_edge 1 -indel_balance_factor_sgs 0.0 -min_count_ratio_skip 0.64 -max_len_kmer 28 -min_len_inter_kmer 6 -max_count_kmer 86	random	575	25	11	0	611
NextPolish	-min_map_quality 3 -max_ins_fold_sgs 4 -max_clip_ratio_sgs 0.19 -trim_len_edge 0 -ext_len_edge 21 -indel_balance_factor_sgs 0.29 -min_count_ratio_skip 0.25 -max_len_kmer 30 -min_len_inter_kmer 1 -max_count_kmer 97	mutated	566	24	8	0	598
NextPolish	-min_map_quality 22 -max_ins_fold_sgs 3 -max_clip_ratio_sgs 0.04 -trim_len_edge 8 -ext_len_edge 0 -indel_balance_factor_sgs 0.8 -min_count_ratio_skip 0.72 -max_len_kmer 100 -min_len_inter_kmer 1 -max_count_kmer 83	random	851	59	17	0	927
NextPolish	-min_map_quality 3 -max_ins_fold_sgs 4 -max_clip_ratio_sgs 0.16 -trim_len_edge 1 -ext_len_edge 21 -indel_balance_factor_sgs 0.32 -min_count_ratio_skip 0.33 -max_len_kmer 30 -min_len_inter_kmer 1 -max_count_kmer 97	mutated	586	23	9	0	618
NextPolish	-min_map_quality 3 -max_ins_fold_sgs 6 -max_clip_ratio_sgs 0.68 -trim_len_edge 8 -ext_len_edge 8 -indel_balance_factor_sgs 0.76 -min_count_ratio_skip 0.94 -max_len_kmer 77 -min_len_inter_kmer 2 -max_count_kmer 55	random	920	81	18	3	1022
NextPolish	-min_map_quality 8 -max_ins_fold_sgs 16 -max_clip_ratio_sgs 0.52 -trim_len_edge 0 -ext_len_edge 6 -indel_balance_factor_sgs 0.04 -min_count_ratio_skip 0.63 -max_len_kmer 48 -min_len_inter_kmer 4 -max_count_kmer 36	random	575	25	11	0	611
NextPolish	-min_map_quality 3 -max_ins_fold_sgs 4 -max_clip_ratio_sgs 0.16 -trim_len_edge 0 -ext_len_edge 21 -indel_balance_factor_sgs 0.29 -min_count_ratio_skip 0.28 -max_len_kmer 30 -min_len_inter_kmer 1 -max_count_kmer 97	mutated	564	24	8	0	596
NextPolish	-min_map_quality 46 -max_ins_fold_sgs 7 -max_clip_ratio_sgs 0.03 -trim_len_edge 7 -ext_len_edge 0 -indel_balance_factor_sgs 0.39 -min_count_ratio_skip 0.91 -max_len_kmer 33 -min_len_inter_kmer 6 -max_count_kmer 3	random	928	84	22	3	1037
NextPolish	-min_map_quality 13 -max_ins_fold_sgs 2 -max_clip_ratio_sgs 0.16 -trim_len_edge 0 -ext_len_edge 21 -indel_balance_factor_sgs 0.29 -min_count_ratio_skip 0.28 -max_len_kmer 30 -min_len_inter_kmer 1 -max_count_kmer 97	mutated	564	24	8	0	596
NextPolish	-min_map_quality 47 -max_ins_fold_sgs 13 -max_clip_ratio_sgs 0.3 -trim_len_edge 10 -ext_len_edge 0 -indel_balance_factor_sgs 0.35 -min_count_ratio_skip 0.9 -max_len_kmer 62 -min_len_inter_kmer 2 -max_count_kmer 38	random	917	80	19	3	1019
NextPolish	-min_map_quality 50 -max_ins_fold_sgs 14 -max_clip_ratio_sgs 0.26 -trim_len_edge 22 -ext_len_edge 10 -indel_balance_factor_sgs 0.61 -min_count_ratio_skip 0.32 -max_len_kmer 11 -min_len_inter_kmer 5 -max_count_kmer 37	random	1347	238	66	18	1669
NextPolish	-min_map_quality 13 -max_ins_fold_sgs 2 -max_clip_ratio_sgs 0.16 -trim_len_edge 0 -ext_len_edge 21 -indel_balance_factor_sgs 0.19 -min_count_ratio_skip 0.28 -max_len_kmer 30 -min_len_inter_kmer 1 -max_count_kmer 97	mutated	564	24	8	0	596
NextPolish	-min_map_quality 15 -max_ins_fold_sgs 11 -max_clip_ratio_sgs 0.06 -trim_len_edge 24 -ext_len_edge 9 -indel_balance_factor_sgs 0.97 -min_count_ratio_skip 0.94 -max_len_kmer 89 -min_len_inter_kmer 10 -max_count_kmer 66	random	907	86	22	3	1018
NextPolish	-min_map_quality 4 -max_ins_fold_sgs 5 -max_clip_ratio_sgs 0.01 -trim_len_edge 22 -ext_len_edge 22 -indel_balance_factor_sgs 0.83 -min_count_ratio_skip 0.81 -max_len_kmer 69 -min_len_inter_kmer 5 -max_count_kmer 36	random	889	83	22	4	998
NextPolish	-min_map_quality 6 -max_ins_fold_sgs 2 -max_clip_ratio_sgs 0.16 -trim_len_edge 0 -ext_len_edge 21 -indel_balance_factor_sgs 0.19 -min_count_ratio_skip 0.28 -max_len_kmer 30 -min_len_inter_kmer 1 -max_count_kmer 97	mutated	564	24	8	0	596
NextPolish	-min_map_quality 1 -max_ins_fold_sgs 12 -max_clip_ratio_sgs 0.16 -trim_len_edge 10 -ext_len_edge 2 -indel_balance_factor_sgs 0.07 -min_count_ratio_skip 0.56 -max_len_kmer 19 -min_len_inter_kmer 2 -max_count_kmer 39	random	694	36	15	0	745
NextPolish	-min_map_quality 6 -max_ins_fold_sgs 2 -max_clip_ratio_sgs 0.21 -trim_len_edge 0 -ext_len_edge 21 -indel_balance_factor_sgs 0.19 -min_count_ratio_skip 0.28 -max_len_kmer 30 -min_len_inter_kmer 1 -max_count_kmer 97	mutated	564	24	8	0	596
NextPolish	-min_map_quality 13 -max_ins_fold_sgs 13 -max_clip_ratio_sgs 0.03 -trim_len_edge 10 -ext_len_edge 4 -indel_balance_factor_sgs 0.47 -min_count_ratio_skip 0.06 -max_len_kmer 67 -min_len_inter_kmer 7 -max_count_kmer 53	random	852	72	24	0	948
NextPolish	-min_map_quality 13 -max_ins_fold_sgs 9 -max_clip_ratio_sgs 0.03 -trim_len_edge 3 -ext_len_edge 19 -indel_balance_factor_sgs 0.57 -min_count_ratio_skip 0.9 -max_len_kmer 78 -min_len_inter_kmer 8 -max_count_kmer 55	random	944	86	23	3	1056
NextPolish	-min_map_quality 6 -max_ins_fold_sgs 2 -max_clip_ratio_sgs 0.21 -trim_len_edge 0 -ext_len_edge 21 -indel_balance_factor_sgs 0.19 -min_count_ratio_skip 0.28 -max_len_kmer 30 -min_len_inter_kmer 2 -max_count_kmer 97	mutated	564	24	8	0	596
NextPolish	-min_map_quality 43 -max_ins_fold_sgs 15 -max_clip_ratio_sgs 0.01 -trim_len_edge 4 -ext_len_edge 5 -indel_balance_factor_sgs 0.45 -min_count_ratio_skip 0.62 -max_len_kmer 27 -min_len_inter_kmer 1 -max_count_kmer 8	random	657	34	16	0	707
NextPolish	-min_map_quality 6 -max_ins_fold_sgs 2 -max_clip_ratio_sgs 0.21 -trim_len_edge 0 -ext_len_edge 21 -indel_balance_factor_sgs 0.19 -min_count_ratio_skip 0.37 -max_len_kmer 30 -min_len_inter_kmer 1 -max_count_kmer 97	mutated	569	24	8	0	601
NextPolish	-min_map_quality 38 -max_ins_fold_sgs 13 -max_clip_ratio_sgs 0.13 -trim_len_edge 1 -ext_len_edge 14 -indel_balance_factor_sgs 0.36 -min_count_ratio_skip 0.92 -max_len_kmer 28 -min_len_inter_kmer 3 -max_count_kmer 18	random	946	89	21	3	1059
NextPolish	-min_map_quality 6 -max_ins_fold_sgs 2 -max_clip_ratio_sgs 0.21 -trim_len_edge 0 -ext_len_edge 21 -indel_balance_factor_sgs 0.11 -min_count_ratio_skip 0.24 -max_len_kmer 30 -min_len_inter_kmer 1 -max_count_kmer 97	mutated	566	24	8	0	598
NextPolish	-min_map_quality 20 -max_ins_fold_sgs 6 -max_clip_ratio_sgs 0.0 -trim_len_edge 14 -ext_len_edge 8 -indel_balance_factor_sgs 0.84 -min_count_ratio_skip 0.7 -max_len_kmer 25 -min_len_inter_kmer 8 -max_count_kmer 9	random	854	73	19	0	946
NextPolish	-min_map_quality 5 -max_ins_fold_sgs 2 -max_clip_ratio_sgs 0.21 -trim_len_edge 0 -ext_len_edge 21 -indel_balance_factor_sgs 0.19 -min_count_ratio_skip 0.28 -max_len_kmer 30 -min_len_inter_kmer 2 -max_count_kmer 97	mutated	564	24	8	0	596
NextPolish	-min_map_quality 35 -max_ins_fold_sgs 6 -max_clip_ratio_sgs 0.0 -trim_len_edge 0 -ext_len_edge 24 -indel_balance_factor_sgs 0.54 -min_count_ratio_skip 0.14 -max_len_kmer 81 -min_len_inter_kmer 4 -max_count_kmer 36	random	566	24	8	0	598
NextPolish	-min_map_quality 5 -max_ins_fold_sgs 2 -max_clip_ratio_sgs 0.21 -trim_len_edge 0 -ext_len_edge 21 -indel_balance_factor_sgs 0.24 -min_count_ratio_skip 0.28 -max_len_kmer 38 -min_len_inter_kmer 2 -max_count_kmer 97	mutated	564	24	8	0	596
NextPolish	-min_map_quality 59 -max_ins_fold_sgs 4 -max_clip_ratio_sgs 0.86 -trim_len_edge 5 -ext_len_edge 2 -indel_balance_factor_sgs 0.06 -min_count_ratio_skip 0.94 -max_len_kmer 40 -min_len_inter_kmer 4 -max_count_kmer 9	random	941	86	22	3	1052
NextPolish	-min_map_quality 5 -max_ins_fold_sgs 1 -max_clip_ratio_sgs 0.21 -trim_len_edge 0 -ext_len_edge 21 -indel_balance_factor_sgs 0.18 -min_count_ratio_skip 0.28 -max_len_kmer 38 -min_len_inter_kmer 2 -max_count_kmer 97	mutated	564	24	8	0	596
NextPolish	-min_map_quality 8 -max_ins_fold_sgs 3 -max_clip_ratio_sgs 0.15 -trim_len_edge 1 -ext_len_edge 0 -indel_balance_factor_sgs 0.89 -min_count_ratio_skip 0.98 -max_len_kmer 24 -min_len_inter_kmer 2 -max_count_kmer 71	random	946	89	21	4	1060
NextPolish	-min_map_quality 54 -max_ins_fold_sgs 2 -max_clip_ratio_sgs 0.02 -trim_len_edge 6 -ext_len_edge 0 -indel_balance_factor_sgs 0.19 -min_count_ratio_skip 0.61 -max_len_kmer 39 -min_len_inter_kmer 6 -max_count_kmer 36	random	683	38	16	0	737
NextPolish	-min_map_quality 7 -max_ins_fold_sgs 13 -max_clip_ratio_sgs 0.03 -trim_len_edge 15 -ext_len_edge 13 -indel_balance_factor_sgs 0.38 -min_count_ratio_skip 0.94 -max_len_kmer 83 -min_len_inter_kmer 8 -max_count_kmer 10	random	908	84	18	3	1013
NextPolish	-min_map_quality 14 -max_ins_fold_sgs 1 -max_clip_ratio_sgs 0.21 -trim_len_edge 2 -ext_len_edge 21 -indel_balance_factor_sgs 0.18 -min_count_ratio_skip 0.28 -max_len_kmer 38 -min_len_inter_kmer 2 -max_count_kmer 97	mutated	602	25	11	0	638
NextPolish	-min_map_quality 31 -max_ins_fold_sgs 15 -max_clip_ratio_sgs 0.02 -trim_len_edge 0 -ext_len_edge 1 -indel_balance_factor_sgs 0.14 -min_count_ratio_skip 0.98 -max_len_kmer 43 -min_len_inter_kmer 5 -max_count_kmer 21	random	957	91	22	4	1074
NextPolish	-min_map_quality 5 -max_ins_fold_sgs 1 -max_clip_ratio_sgs 0.21 -trim_len_edge 0 -ext_len_edge 21 -indel_balance_factor_sgs 0.18 -min_count_ratio_skip 0.28 -max_len_kmer 38 -min_len_inter_kmer 1 -max_count_kmer 97	mutated	564	24	8	0	596
NextPolish	-min_map_quality 38 -max_ins_fold_sgs 3 -max_clip_ratio_sgs 0.0 -trim_len_edge 12 -ext_len_edge 3 -indel_balance_factor_sgs 0.38 -min_count_ratio_skip 0.95 -max_len_kmer 22 -min_len_inter_kmer 2 -max_count_kmer 92	random	904	82	20	3	1009
NextPolish	-min_map_quality 5 -max_ins_fold_sgs 1 -max_clip_ratio_sgs 0.12 -trim_len_edge 0 -ext_len_edge 21 -indel_balance_factor_sgs 0.18 -min_count_ratio_skip 0.28 -max_len_kmer 30 -min_len_inter_kmer 1 -max_count_kmer 97	mutated	564	24	8	0	596
NextPolish	-min_map_quality 39 -max_ins_fold_sgs 10 -max_clip_ratio_sgs 0.0 -trim_len_edge 4 -ext_len_edge 6 -indel_balance_factor_sgs 0.83 -min_count_ratio_skip 0.78 -max_len_kmer 23 -min_len_inter_kmer 9 -max_count_kmer 45	random	896	68	23	0	987
NextPolish	-min_map_quality 54 -max_ins_fold_sgs 15 -max_clip_ratio_sgs 0.09 -trim_len_edge 0 -ext_len_edge 2 -indel_balance_factor_sgs 0.85 -min_count_ratio_skip 0.85 -max_len_kmer 67 -min_len_inter_kmer 5 -max_count_kmer 47	random	936	78	20	3	1037
NextPolish	-min_map_quality 52 -max_ins_fold_sgs 3 -max_clip_ratio_sgs 0.0 -trim_len_edge 6 -ext_len_edge 5 -indel_balance_factor_sgs 0.02 -min_count_ratio_skip 0.94 -max_len_kmer 13 -min_len_inter_kmer 4 -max_count_kmer 55	random	938	86	22	3	1049
NextPolish	-min_map_quality 5 -max_ins_fold_sgs 1 -max_clip_ratio_sgs 0.12 -trim_len_edge 0 -ext_len_edge 19 -indel_balance_factor_sgs 0.18 -min_count_ratio_skip 0.28 -max_len_kmer 20 -min_len_inter_kmer 1 -max_count_kmer 97	mutated	564	24	8	0	596
NextPolish	-min_map_quality 5 -max_ins_fold_sgs 4 -max_clip_ratio_sgs 0.68 -trim_len_edge 18 -ext_len_edge 1 -indel_balance_factor_sgs 0.46 -min_count_ratio_skip 0.42 -max_len_kmer 43 -min_len_inter_kmer 5 -max_count_kmer 8	random	1118	162	46	10	1336
NextPolish	-min_map_quality 5 -max_ins_fold_sgs 1 -max_clip_ratio_sgs 0.12 -trim_len_edge 0 -ext_len_edge 19 -indel_balance_factor_sgs 0.18 -min_count_ratio_skip 0.3 -max_len_kmer 20 -min_len_inter_kmer 1 -max_count_kmer 97	mutated	564	24	8	0	596
NextPolish	-min_map_quality 13 -max_ins_fold_sgs 14 -max_clip_ratio_sgs 0.02 -trim_len_edge 2 -ext_len_edge 12 -indel_balance_factor_sgs 0.47 -min_count_ratio_skip 0.88 -max_len_kmer 96 -min_len_inter_kmer 10 -max_count_kmer 82	random	943	84	21	3	1051
NextPolish	-min_map_quality 5 -max_ins_fold_sgs 1 -max_clip_ratio_sgs 0.12 -trim_len_edge 0 -ext_len_edge 19 -indel_balance_factor_sgs 0.18 -min_count_ratio_skip 0.3 -max_len_kmer 20 -min_len_inter_kmer 1 -max_count_kmer 104	mutated	564	24	8	0	596
NextPolish	-min_map_quality 28 -max_ins_fold_sgs 3 -max_clip_ratio_sgs 0.24 -trim_len_edge 0 -ext_len_edge 4 -indel_balance_factor_sgs 0.43 -min_count_ratio_skip 0.5 -max_len_kmer 12 -min_len_inter_kmer 7 -max_count_kmer 78	random	567	24	8	0	599
NextPolish	-min_map_quality 5 -max_ins_fold_sgs 1 -max_clip_ratio_sgs 0.04 -trim_len_edge 0 -ext_len_edge 19 -indel_balance_factor_sgs 0.18 -min_count_ratio_skip 0.3 -max_len_kmer 20 -min_len_inter_kmer 1 -max_count_kmer 104	mutated	564	24	8	0	596
NextPolish	-min_map_quality 6 -max_ins_fold_sgs 12 -max_clip_ratio_sgs 0.02 -trim_len_edge 8 -ext_len_edge 0 -indel_balance_factor_sgs 0.6 -min_count_ratio_skip 0.86 -max_len_kmer 53 -min_len_inter_kmer 2 -max_count_kmer 85	random	918	80	18	3	1019
NextPolish	-min_map_quality 5 -max_ins_fold_sgs 1 -max_clip_ratio_sgs 0.04 -trim_len_edge 0 -ext_len_edge 19 -indel_balance_factor_sgs 0.26 -min_count_ratio_skip 0.38 -max_len_kmer 20 -min_len_inter_kmer 1 -max_count_kmer 104	mutated	569	24	8	0	601
NextPolish	-min_map_quality 14 -max_ins_fold_sgs 1 -max_clip_ratio_sgs 0.0 -trim_len_edge 3 -ext_len_edge 23 -indel_balance_factor_sgs 0.2 -min_count_ratio_skip 0.4 -max_len_kmer 38 -min_len_inter_kmer 6 -max_count_kmer 30	random	633	29	12	0	674
NextPolish	-min_map_quality 1 -max_ins_fold_sgs 1 -max_clip_ratio_sgs 0.04 -trim_len_edge 0 -ext_len_edge 19 -indel_balance_factor_sgs 0.18 -min_count_ratio_skip 0.3 -max_len_kmer 20 -min_len_inter_kmer 1 -max_count_kmer 113	mutated	564	24	8	0	596
NextPolish	-min_map_quality 34 -max_ins_fold_sgs 1 -max_clip_ratio_sgs 0.01 -trim_len_edge 2 -ext_len_edge 12 -indel_balance_factor_sgs 0.41 -min_count_ratio_skip 0.96 -max_len_kmer 78 -min_len_inter_kmer 6 -max_count_kmer 30	random	945	89	21	4	1059
NextPolish	-min_map_quality 0 -max_ins_fold_sgs 3 -max_clip_ratio_sgs 0.41 -trim_len_edge 1 -ext_len_edge 17 -indel_balance_factor_sgs 0.86 -min_count_ratio_skip 0.95 -max_len_kmer 97 -min_len_inter_kmer 8 -max_count_kmer 86	random	946	89	21	3	1059
NextPolish	-min_map_quality 1 -max_ins_fold_sgs 1 -max_clip_ratio_sgs 0.04 -trim_len_edge 0 -ext_len_edge 18 -indel_balance_factor_sgs 0.18 -min_count_ratio_skip 0.3 -max_len_kmer 20 -min_len_inter_kmer 1 -max_count_kmer 113	mutated	564	24	8	0	596
NextPolish	-min_map_quality 40 -max_ins_fold_sgs 9 -max_clip_ratio_sgs 0.06 -trim_len_edge 14 -ext_len_edge 9 -indel_balance_factor_sgs 0.0 -min_count_ratio_skip 0.41 -max_len_kmer 28 -min_len_inter_kmer 10 -max_count_kmer 58	random	962	118	29	0	1109
NextPolish	-min_map_quality 52 -max_ins_fold_sgs 8 -max_clip_ratio_sgs 0.16 -trim_len_edge 17 -ext_len_edge 16 -indel_balance_factor_sgs 0.77 -min_count_ratio_skip 1.0 -max_len_kmer 19 -min_len_inter_kmer 8 -max_count_kmer 97	random	923	86	18	5	1032
NextPolish	-min_map_quality 1 -max_ins_fold_sgs 1 -max_clip_ratio_sgs 0.04 -trim_len_edge 1 -ext_len_edge 17 -indel_balance_factor_sgs 0.18 -min_count_ratio_skip 0.3 -max_len_kmer 20 -min_len_inter_kmer 1 -max_count_kmer 113	mutated	586	23	9	0	618
NextPolish	-min_map_quality 44 -max_ins_fold_sgs 10 -max_clip_ratio_sgs 0.1 -trim_len_edge 7 -ext_len_edge 0 -indel_balance_factor_sgs 0.82 -min_count_ratio_skip 0.95 -max_len_kmer 37 -min_len_inter_kmer 8 -max_count_kmer 16	random	928	84	22	3	1037
NextPolish	-min_map_quality 1 -max_ins_fold_sgs 1 -max_clip_ratio_sgs 0.04 -trim_len_edge 2 -ext_len_edge 18 -indel_balance_factor_sgs 0.11 -min_count_ratio_skip 0.3 -max_len_kmer 20 -min_len_inter_kmer 1 -max_count_kmer 113	mutated	602	25	11	0	638
NextPolish	-min_map_quality 53 -max_ins_fold_sgs 12 -max_clip_ratio_sgs 0.57 -trim_len_edge 1 -ext_len_edge 3 -indel_balance_factor_sgs 0.55 -min_count_ratio_skip 0.85 -max_len_kmer 25 -min_len_inter_kmer 6 -max_count_kmer 73	random	931	78	21	3	1033
NextPolish	-min_map_quality 7 -max_ins_fold_sgs 1 -max_clip_ratio_sgs 0.04 -trim_len_edge 0 -ext_len_edge 18 -indel_balance_factor_sgs 0.18 -min_count_ratio_skip 0.3 -max_len_kmer 20 -min_len_inter_kmer 1 -max_count_kmer 113	mutated	564	24	8	0	596
NextPolish	-min_map_quality 38 -max_ins_fold_sgs 7 -max_clip_ratio_sgs 0.08 -trim_len_edge 1 -ext_len_edge 11 -indel_balance_factor_sgs 0.93 -min_count_ratio_skip 0.79 -max_len_kmer 58 -min_len_inter_kmer 6 -max_count_kmer 29	random	870	62	17	0	949
NextPolish	-min_map_quality 39 -max_ins_fold_sgs 1 -max_clip_ratio_sgs 0.01 -trim_len_edge 12 -ext_len_edge 4 -indel_balance_factor_sgs 0.45 -min_count_ratio_skip 0.47 -max_len_kmer 49 -min_len_inter_kmer 9 -max_count_kmer 56	random	887	86	26	0	999
NextPolish	-min_map_quality 7 -max_ins_fold_sgs 1 -max_clip_ratio_sgs 0.04 -trim_len_edge 0 -ext_len_edge 18 -indel_balance_factor_sgs 0.18 -min_count_ratio_skip 0.3 -max_len_kmer 20 -min_len_inter_kmer 1 -max_count_kmer 120	mutated	564	24	8	0	596
NextPolish	-min_map_quality 17 -max_ins_fold_sgs 16 -max_clip_ratio_sgs 0.0 -trim_len_edge 2 -ext_len_edge 22 -indel_balance_factor_sgs 0.6 -min_count_ratio_skip 0.03 -max_len_kmer 11 -min_len_inter_kmer 1 -max_count_kmer 14	random	604	25	11	0	640
NextPolish	-min_map_quality 7 -max_ins_fold_sgs 1 -max_clip_ratio_sgs 0.04 -trim_len_edge 0 -ext_len_edge 17 -indel_balance_factor_sgs 0.18 -min_count_ratio_skip 0.3 -max_len_kmer 20 -min_len_inter_kmer 1 -max_count_kmer 120	mutated	564	24	8	0	596
NextPolish	-min_map_quality 13 -max_ins_fold_sgs 15 -max_clip_ratio_sgs 0.08 -trim_len_edge 6 -ext_len_edge 2 -indel_balance_factor_sgs 0.65 -min_count_ratio_skip 0.41 -max_len_kmer 55 -min_len_inter_kmer 8 -max_count_kmer 36	random	703	40	17	0	760
NextPolish	-min_map_quality 7 -max_ins_fold_sgs 1 -max_clip_ratio_sgs 0.04 -trim_len_edge 2 -ext_len_edge 17 -indel_balance_factor_sgs 0.18 -min_count_ratio_skip 0.3 -max_len_kmer 20 -min_len_inter_kmer 2 -max_count_kmer 120	mutated	602	25	11	0	638
NextPolish	-min_map_quality 33 -max_ins_fold_sgs 4 -max_clip_ratio_sgs 0.5 -trim_len_edge 27 -ext_len_edge 5 -indel_balance_factor_sgs 0.21 -min_count_ratio_skip 0.39 -max_len_kmer 18 -min_len_inter_kmer 1 -max_count_kmer 68	random	1493	332	101	32	1958
NextPolish	-min_map_quality 37 -max_ins_fold_sgs 14 -max_clip_ratio_sgs 0.89 -trim_len_edge 0 -ext_len_edge 25 -indel_balance_factor_sgs 0.9 -min_count_ratio_skip 1.0 -max_len_kmer 100 -min_len_inter_kmer 6 -max_count_kmer 94	random	957	91	22	4	1074
NextPolish	-min_map_quality 35 -max_ins_fold_sgs 2 -max_clip_ratio_sgs 0.32 -trim_len_edge 3 -ext_len_edge 0 -indel_balance_factor_sgs 0.71 -min_count_ratio_skip 0.78 -max_len_kmer 16 -min_len_inter_kmer 8 -max_count_kmer 16	random	889	66	20	0	975
NextPolish	-min_map_quality 7 -max_ins_fold_sgs 1 -max_clip_ratio_sgs 0.04 -trim_len_edge 0 -ext_len_edge 17 -indel_balance_factor_sgs 0.18 -min_count_ratio_skip 0.3 -max_len_kmer 20 -min_len_inter_kmer 1 -max_count_kmer 127	mutated	564	24	8	0	596
NextPolish	-min_map_quality 56 -max_ins_fold_sgs 10 -max_clip_ratio_sgs 0.01 -trim_len_edge 2 -ext_len_edge 3 -indel_balance_factor_sgs 0.23 -min_count_ratio_skip 0.95 -max_len_kmer 55 -min_len_inter_kmer 3 -max_count_kmer 23	random	945	89	21	3	1058
NextPolish	-min_map_quality 3 -max_ins_fold_sgs 2 -max_clip_ratio_sgs 0.61 -trim_len_edge 3 -ext_len_edge 3 -indel_balance_factor_sgs 0.02 -min_count_ratio_skip 0.99 -max_len_kmer 88 -min_len_inter_kmer 8 -max_count_kmer 88	random	944	88	23	4	1059
NextPolish	-min_map_quality 7 -max_ins_fold_sgs 1 -max_clip_ratio_sgs 0.04 -trim_len_edge 0 -ext_len_edge 16 -indel_balance_factor_sgs 0.18 -min_count_ratio_skip 0.3 -max_len_kmer 29 -min_len_inter_kmer 1 -max_count_kmer 129	mutated	564	24	8	0	596
NextPolish	-min_map_quality 39 -max_ins_fold_sgs 8 -max_clip_ratio_sgs 0.23 -trim_len_edge 2 -ext_len_edge 0 -indel_balance_factor_sgs 0.36 -min_count_ratio_skip 0.94 -max_len_kmer 14 -min_len_inter_kmer 5 -max_count_kmer 57	random	945	89	21	3	1058
NextPolish	-min_map_quality 7 -max_ins_fold_sgs 1 -max_clip_ratio_sgs 0.04 -trim_len_edge 0 -ext_len_edge 16 -indel_balance_factor_sgs 0.12 -min_count_ratio_skip 0.3 -max_len_kmer 35 -min_len_inter_kmer 1 -max_count_kmer 129	mutated	564	24	8	0	596
NextPolish	-min_map_quality 17 -max_ins_fold_sgs 2 -max_clip_ratio_sgs 0.03 -trim_len_edge 10 -ext_len_edge 19 -indel_balance_factor_sgs 0.69 -min_count_ratio_skip 0.55 -max_len_kmer 97 -min_len_inter_kmer 2 -max_count_kmer 81	random	694	36	15	0	745
NextPolish	-min_map_quality 40 -max_ins_fold_sgs 7 -max_clip_ratio_sgs 0.53 -trim_len_edge 4 -ext_len_edge 1 -indel_balance_factor_sgs 0.09 -min_count_ratio_skip 0.81 -max_len_kmer 69 -min_len_inter_kmer 7 -max_count_kmer 18	random	924	74	23	0	1021
NextPolish	-min_map_quality 7 -max_ins_fold_sgs 1 -max_clip_ratio_sgs 0.01 -trim_len_edge 0 -ext_len_edge 16 -indel_balance_factor_sgs 0.12 -min_count_ratio_skip 0.31 -max_len_kmer 35 -min_len_inter_kmer 1 -max_count_kmer 129	mutated	564	24	8	0	596
NextPolish	-min_map_quality 1 -max_ins_fold_sgs 15 -max_clip_ratio_sgs 0.04 -trim_len_edge 14 -ext_len_edge 2 -indel_balance_factor_sgs 0.71 -min_count_ratio_skip 0.15 -max_len_kmer 89 -min_len_inter_kmer 4 -max_count_kmer 54	random	1004	129	36	0	1169
NextPolish	-min_map_quality 9 -max_ins_fold_sgs 1 -max_clip_ratio_sgs 0.01 -trim_len_edge 0 -ext_len_edge 16 -indel_balance_factor_sgs 0.12 -min_count_ratio_skip 0.31 -max_len_kmer 35 -min_len_inter_kmer 1 -max_count_kmer 129	mutated	564	24	8	0	596
NextPolish	-min_map_quality 4 -max_ins_fold_sgs 1 -max_clip_ratio_sgs 0.58 -trim_len_edge 11 -ext_len_edge 24 -indel_balance_factor_sgs 0.93 -min_count_ratio_skip 0.83 -max_len_kmer 55 -min_len_inter_kmer 8 -max_count_kmer 78	random	903	71	21	3	998
NextPolish	-min_map_quality 9 -max_ins_fold_sgs 1 -max_clip_ratio_sgs 0.01 -trim_len_edge 2 -ext_len_edge 16 -indel_balance_factor_sgs 0.12 -min_count_ratio_skip 0.31 -max_len_kmer 35 -min_len_inter_kmer 1 -max_count_kmer 129	mutated	602	25	11	0	638
NextPolish	-min_map_quality 3 -max_ins_fold_sgs 12 -max_clip_ratio_sgs 0.14 -trim_len_edge 0 -ext_len_edge 13 -indel_balance_factor_sgs 0.12 -min_count_ratio_skip 0.81 -max_len_kmer 62 -min_len_inter_kmer 5 -max_count_kmer 26	random	909	72	17	0	998
NextPolish	-min_map_quality 3 -max_ins_fold_sgs 1 -max_clip_ratio_sgs 0.01 -trim_len_edge 0 -ext_len_edge 16 -indel_balance_factor_sgs 0.12 -min_count_ratio_skip 0.31 -max_len_kmer 35 -min_len_inter_kmer 1 -max_count_kmer 129	mutated	564	24	8	0	596
NextPolish	-min_map_quality 5 -max_ins_fold_sgs 2 -max_clip_ratio_sgs 0.0 -trim_len_edge 18 -ext_len_edge 25 -indel_balance_factor_sgs 0.07 -min_count_ratio_skip 0.92 -max_len_kmer 21 -min_len_inter_kmer 8 -max_count_kmer 44	random	915	82	21	5	1023
NextPolish	-min_map_quality 3 -max_ins_fold_sgs 1 -max_clip_ratio_sgs 0.01 -trim_len_edge 0 -ext_len_edge 16 -indel_balance_factor_sgs 0.12 -min_count_ratio_skip 0.36 -max_len_kmer 35 -min_len_inter_kmer 1 -max_count_kmer 129	mutated	569	24	8	0	601
NextPolish	-min_map_quality 20 -max_ins_fold_sgs 15 -max_clip_ratio_sgs 0.17 -trim_len_edge 0 -ext_len_edge 0 -indel_balance_factor_sgs 0.59 -min_count_ratio_skip 0.83 -max_len_kmer 58 -min_len_inter_kmer 2 -max_count_kmer 99	random	909	72	17	0	998
NextPolish	-min_map_quality 0 -max_ins_fold_sgs 1 -max_clip_ratio_sgs 0.01 -trim_len_edge 0 -ext_len_edge 16 -indel_balance_factor_sgs 0.12 -min_count_ratio_skip 0.31 -max_len_kmer 35 -min_len_inter_kmer 1 -max_count_kmer 129	mutated	564	24	8	0	596
NextPolish	-min_map_quality 27 -max_ins_fold_sgs 10 -max_clip_ratio_sgs 0.22 -trim_len_edge 4 -ext_len_edge 26 -indel_balance_factor_sgs 0.02 -min_count_ratio_skip 0.77 -max_len_kmer 67 -min_len_inter_kmer 2 -max_count_kmer 95	random	896	68	23	0	987
NextPolish	-min_map_quality 0 -max_ins_fold_sgs 1 -max_clip_ratio_sgs 0.01 -trim_len_edge 0 -ext_len_edge 16 -indel_balance_factor_sgs 0.12 -min_count_ratio_skip 0.33 -max_len_kmer 35 -min_len_inter_kmer 1 -max_count_kmer 125	mutated	564	24	8	0	596
NextPolish	-min_map_quality 47 -max_ins_fold_sgs 12 -max_clip_ratio_sgs 0.08 -trim_len_edge 0 -ext_len_edge 1 -indel_balance_factor_sgs 0.5 -min_count_ratio_skip 0.79 -max_len_kmer 52 -min_len_inter_kmer 5 -max_count_kmer 64	random	862	62	16	0	940
NextPolish	-min_map_quality 0 -max_ins_fold_sgs 1 -max_clip_ratio_sgs 0.01 -trim_len_edge 0 -ext_len_edge 16 -indel_balance_factor_sgs 0.12 -min_count_ratio_skip 0.33 -max_len_kmer 35 -min_len_inter_kmer 2 -max_count_kmer 125	mutated	564	24	8	0	596
NextPolish	-min_map_quality 29 -max_ins_fold_sgs 2 -max_clip_ratio_sgs 0.22 -trim_len_edge 1 -ext_len_edge 1 -indel_balance_factor_sgs 0.15 -min_count_ratio_skip 0.97 -max_len_kmer 64 -min_len_inter_kmer 1 -max_count_kmer 65	random	946	89	21	4	1060
NextPolish	-min_map_quality 10 -max_ins_fold_sgs 1 -max_clip_ratio_sgs 0.01 -trim_len_edge 0 -ext_len_edge 16 -indel_balance_factor_sgs 0.12 -min_count_ratio_skip 0.33 -max_len_kmer 35 -min_len_inter_kmer 2 -max_count_kmer 125	mutated	564	24	8	0	596
NextPolish	-min_map_quality 26 -max_ins_fold_sgs 6 -max_clip_ratio_sgs 0.0 -trim_len_edge 24 -ext_len_edge 1 -indel_balance_factor_sgs 0.7 -min_count_ratio_skip 0.78 -max_len_kmer 14 -min_len_inter_kmer 1 -max_count_kmer 9	random	901	84	22	3	1010
NextPolish	-min_map_quality 10 -max_ins_fold_sgs 1 -max_clip_ratio_sgs 0.01 -trim_len_edge 0 -ext_len_edge 16 -indel_balance_factor_sgs 0.12 -min_count_ratio_skip 0.33 -max_len_kmer 28 -min_len_inter_kmer 4 -max_count_kmer 125	mutated	564	24	8	0	596
NextPolish	-min_map_quality 51 -max_ins_fold_sgs 2 -max_clip_ratio_sgs 0.01 -trim_len_edge 4 -ext_len_edge 3 -indel_balance_factor_sgs 0.37 -min_count_ratio_skip 0.31 -max_len_kmer 70 -min_len_inter_kmer 10 -max_count_kmer 30	random	656	34	16	0	706
NextPolish	-min_map_quality 10 -max_ins_fold_sgs 1 -max_clip_ratio_sgs 0.01 -trim_len_edge 0 -ext_len_edge 16 -indel_balance_factor_sgs 0.12 -min_count_ratio_skip 0.33 -max_len_kmer 28 -min_len_inter_kmer 4 -max_count_kmer 119	mutated	564	24	8	0	596
NextPolish	-min_map_quality 39 -max_ins_fold_sgs 2 -max_clip_ratio_sgs 0.02 -trim_len_edge 1 -ext_len_edge 10 -indel_balance_factor_sgs 0.89 -min_count_ratio_skip 0.79 -max_len_kmer 97 -min_len_inter_kmer 7 -max_count_kmer 34	random	870	62	17	0	949
NextPolish	-min_map_quality 10 -max_ins_fold_sgs 1 -max_clip_ratio_sgs 0.01 -trim_len_edge 0 -ext_len_edge 16 -indel_balance_factor_sgs 0.14 -min_count_ratio_skip 0.33 -max_len_kmer 28 -min_len_inter_kmer 4 -max_count_kmer 119	mutated	564	24	8	0	596
NextPolish	-min_map_quality 56 -max_ins_fold_sgs 4 -max_clip_ratio_sgs 0.0 -trim_len_edge 22 -ext_len_edge 16 -indel_balance_factor_sgs 0.31 -min_count_ratio_skip 0.8 -max_len_kmer 47 -min_len_inter_kmer 5 -max_count_kmer 43	random	884	82	22	4	992
NextPolish	-min_map_quality 10 -max_ins_fold_sgs 1 -max_clip_ratio_sgs 0.01 -trim_len_edge 0 -ext_len_edge 16 -indel_balance_factor_sgs 0.22 -min_count_ratio_skip 0.33 -max_len_kmer 28 -min_len_inter_kmer 4 -max_count_kmer 119	mutated	564	24	8	0	596
NextPolish	-min_map_quality 57 -max_ins_fold_sgs 14 -max_clip_ratio_sgs 0.12 -trim_len_edge 13 -ext_len_edge 5 -indel_balance_factor_sgs 0.36 -min_count_ratio_skip 0.73 -max_len_kmer 43 -min_len_inter_kmer 2 -max_count_kmer 34	random	847	65	19	0	931
NextPolish	-min_map_quality 34 -max_ins_fold_sgs 3 -max_clip_ratio_sgs 0.13 -trim_len_edge 21 -ext_len_edge 5 -indel_balance_factor_sgs 0.15 -min_count_ratio_skip 0.11 -max_len_kmer 98 -min_len_inter_kmer 8 -max_count_kmer 16	random	1305	229	64	17	1615
NextPolish	-min_map_quality 10 -max_ins_fold_sgs 1 -max_clip_ratio_sgs 0.01 -trim_len_edge 1 -ext_len_edge 16 -indel_balance_factor_sgs 0.22 -min_count_ratio_skip 0.33 -max_len_kmer 28 -min_len_inter_kmer 4 -max_count_kmer 119	mutated	586	23	9	0	618
NextPolish	-min_map_quality 19 -max_ins_fold_sgs 6 -max_clip_ratio_sgs 0.79 -trim_len_edge 0 -ext_len_edge 24 -indel_balance_factor_sgs 0.55 -min_count_ratio_skip 0.87 -max_len_kmer 55 -min_len_inter_kmer 3 -max_count_kmer 59	random	940	84	20	3	1047
NextPolish	-min_map_quality 27 -max_ins_fold_sgs 8 -max_clip_ratio_sgs 0.04 -trim_len_edge 2 -ext_len_edge 0 -indel_balance_factor_sgs 0.27 -min_count_ratio_skip 0.99 -max_len_kmer 76 -min_len_inter_kmer 5 -max_count_kmer 7	random	945	89	21	4	1059
NextPolish	-min_map_quality 20 -max_ins_fold_sgs 1 -max_clip_ratio_sgs 0.0 -trim_len_edge 0 -ext_len_edge 16 -indel_balance_factor_sgs 0.22 -min_count_ratio_skip 0.33 -max_len_kmer 28 -min_len_inter_kmer 4 -max_count_kmer 119	mutated	564	24	8	0	596
NextPolish	-min_map_quality 10 -max_ins_fold_sgs 9 -max_clip_ratio_sgs 0.05 -trim_len_edge 0 -ext_len_edge 7 -indel_balance_factor_sgs 0.76 -min_count_ratio_skip 0.53 -max_len_kmer 93 -min_len_inter_kmer 5 -max_count_kmer 66	random	563	23	10	0	596
NextPolish	-min_map_quality 10 -max_ins_fold_sgs 9 -max_clip_ratio_sgs 0.05 -trim_len_edge 2 -ext_len_edge 7 -indel_balance_factor_sgs 0.76 -min_count_ratio_skip 0.53 -max_len_kmer 93 -min_len_inter_kmer 5 -max_count_kmer 65	mutated	601	25	13	0	639
NextPolish	-min_map_quality 39 -max_ins_fold_sgs 7 -max_clip_ratio_sgs 0.02 -trim_len_edge 3 -ext_len_edge 1 -indel_balance_factor_sgs 0.11 -min_count_ratio_skip 0.12 -max_len_kmer 96 -min_len_inter_kmer 5 -max_count_kmer 87	random	631	29	12	0	672
NextPolish	-min_map_quality 10 -max_ins_fold_sgs 9 -max_clip_ratio_sgs 0.05 -trim_len_edge 1 -ext_len_edge 7 -indel_balance_factor_sgs 0.76 -min_count_ratio_skip 0.59 -max_len_kmer 93 -min_len_inter_kmer 5 -max_count_kmer 66	mutated	583	22	12	0	617
NextPolish	-min_map_quality 15 -max_ins_fold_sgs 14 -max_clip_ratio_sgs 0.12 -trim_len_edge 3 -ext_len_edge 1 -indel_balance_factor_sgs 0.56 -min_count_ratio_skip 0.66 -max_len_kmer 100 -min_len_inter_kmer 6 -max_count_kmer 12	random	640	30	16	0	686
NextPolish	-min_map_quality 10 -max_ins_fold_sgs 9 -max_clip_ratio_sgs 0.05 -trim_len_edge 0 -ext_len_edge 7 -indel_balance_factor_sgs 0.76 -min_count_ratio_skip 0.57 -max_len_kmer 93 -min_len_inter_kmer 5 -max_count_kmer 66	mutated	563	23	10	0	596
NextPolish	-min_map_quality 48 -max_ins_fold_sgs 1 -max_clip_ratio_sgs 0.03 -trim_len_edge 7 -ext_len_edge 11 -indel_balance_factor_sgs 0.05 -min_count_ratio_skip 0.39 -max_len_kmer 73 -min_len_inter_kmer 1 -max_count_kmer 24	random	725	44	18	0	787
NextPolish	-min_map_quality 19 -max_ins_fold_sgs 9 -max_clip_ratio_sgs 0.05 -trim_len_edge 2 -ext_len_edge 7 -indel_balance_factor_sgs 0.69 -min_count_ratio_skip 0.57 -max_len_kmer 93 -min_len_inter_kmer 5 -max_count_kmer 66	mutated	601	25	13	0	639
NextPolish	-min_map_quality 39 -max_ins_fold_sgs 1 -max_clip_ratio_sgs 0.87 -trim_len_edge 1 -ext_len_edge 0 -indel_balance_factor_sgs 0.43 -min_count_ratio_skip 0.56 -max_len_kmer 78 -min_len_inter_kmer 8 -max_count_kmer 63	random	583	22	12	0	617
NextPolish	-min_map_quality 10 -max_ins_fold_sgs 9 -max_clip_ratio_sgs 0.05 -trim_len_edge 0 -ext_len_edge 7 -indel_balance_factor_sgs 0.76 -min_count_ratio_skip 0.57 -max_len_kmer 100 -min_len_inter_kmer 5 -max_count_kmer 66	mutated	563	23	10	0	596
NextPolish	-min_map_quality 42 -max_ins_fold_sgs 2 -max_clip_ratio_sgs 0.2 -trim_len_edge 21 -ext_len_edge 0 -indel_balance_factor_sgs 0.1 -min_count_ratio_skip 0.52 -max_len_kmer 83 -min_len_inter_kmer 10 -max_count_kmer 92	random	751	57	20	1	829
NextPolish	-min_map_quality 25 -max_ins_fold_sgs 1 -max_clip_ratio_sgs 0.17 -trim_len_edge 15 -ext_len_edge 15 -indel_balance_factor_sgs 0.66 -min_count_ratio_skip 0.99 -max_len_kmer 63 -min_len_inter_kmer 7 -max_count_kmer 77	random	908	84	18	3	1013
NextPolish	-min_map_quality 10 -max_ins_fold_sgs 9 -max_clip_ratio_sgs 0.05 -trim_len_edge 0 -ext_len_edge 7 -indel_balance_factor_sgs 0.76 -min_count_ratio_skip 0.57 -max_len_kmer 109 -min_len_inter_kmer 7 -max_count_kmer 66	mutated	563	23	10	0	596
NextPolish	-min_map_quality 12 -max_ins_fold_sgs 7 -max_clip_ratio_sgs 0.8 -trim_len_edge 1 -ext_len_edge 2 -indel_balance_factor_sgs 0.67 -min_count_ratio_skip 0.14 -max_len_kmer 25 -min_len_inter_kmer 6 -max_count_kmer 14	random	588	23	9	0	620
NextPolish	-min_map_quality 2 -max_ins_fold_sgs 8 -max_clip_ratio_sgs 0.0 -trim_len_edge 0 -ext_len_edge 0 -indel_balance_factor_sgs 0.27 -min_count_ratio_skip 0.24 -max_len_kmer 16 -min_len_inter_kmer 6 -max_count_kmer 11	random	566	24	8	0	598
NextPolish	-min_map_quality 10 -max_ins_fold_sgs 9 -max_clip_ratio_sgs 0.05 -trim_len_edge 0 -ext_len_edge 8 -indel_balance_factor_sgs 0.76 -min_count_ratio_skip 0.57 -max_len_kmer 109 -min_len_inter_kmer 7 -max_count_kmer 66	mutated	563	23	10	0	596
NextPolish	-min_map_quality 56 -max_ins_fold_sgs 15 -max_clip_ratio_sgs 0.16 -trim_len_edge 18 -ext_len_edge 22 -indel_balance_factor_sgs 0.68 -min_count_ratio_skip 0.91 -max_len_kmer 89 -min_len_inter_kmer 3 -max_count_kmer 96	random	915	82	21	5	1023
NextPolish	-min_map_quality 10 -max_ins_fold_sgs 9 -max_clip_ratio_sgs 0.05 -trim_len_edge 0 -ext_len_edge 8 -indel_balance_factor_sgs 0.76 -min_count_ratio_skip 0.57 -max_len_kmer 109 -min_len_inter_kmer 7 -max_count_kmer 69	mutated	563	23	10	0	596
NextPolish	-min_map_quality 22 -max_ins_fold_sgs 2 -max_clip_ratio_sgs 0.01 -trim_len_edge 18 -ext_len_edge 19 -indel_balance_factor_sgs 0.91 -min_count_ratio_skip 0.41 -max_len_kmer 94 -min_len_inter_kmer 5 -max_count_kmer 13	random	1118	162	46	10	1336
NextPolish	-min_map_quality 10 -max_ins_fold_sgs 9 -max_clip_ratio_sgs 0.05 -trim_len_edge 0 -ext_len_edge 10 -indel_balance_factor_sgs 0.76 -min_count_ratio_skip 0.57 -max_len_kmer 109 -min_len_inter_kmer 8 -max_count_kmer 69	mutated	563	23	10	0	596
NextPolish	-min_map_quality 4 -max_ins_fold_sgs 12 -max_clip_ratio_sgs 0.05 -trim_len_edge 21 -ext_len_edge 0 -indel_balance_factor_sgs 0.19 -min_count_ratio_skip 0.77 -max_len_kmer 93 -min_len_inter_kmer 6 -max_count_kmer 91	random	880	77	23	4	984
NextPolish	-min_map_quality 7 -max_ins_fold_sgs 9 -max_clip_ratio_sgs 0.05 -trim_len_edge 0 -ext_len_edge 10 -indel_balance_factor_sgs 0.76 -min_count_ratio_skip 0.57 -max_len_kmer 109 -min_len_inter_kmer 8 -max_count_kmer 69	mutated	563	23	10	0	596
NextPolish	-min_map_quality 4 -max_ins_fold_sgs 12 -max_clip_ratio_sgs 0.07 -trim_len_edge 7 -ext_len_edge 18 -indel_balance_factor_sgs 0.69 -min_count_ratio_skip 0.7 -max_len_kmer 55 -min_len_inter_kmer 6 -max_count_kmer 59	random	857	59	21	0	937
NextPolish	-min_map_quality 7 -max_ins_fold_sgs 9 -max_clip_ratio_sgs 0.05 -trim_len_edge 0 -ext_len_edge 10 -indel_balance_factor_sgs 0.76 -min_count_ratio_skip 0.67 -max_len_kmer 109 -min_len_inter_kmer 8 -max_count_kmer 69	mutated	777	46	13	0	836
NextPolish	-min_map_quality 24 -max_ins_fold_sgs 2 -max_clip_ratio_sgs 0.0 -trim_len_edge 3 -ext_len_edge 23 -indel_balance_factor_sgs 0.3 -min_count_ratio_skip 0.84 -max_len_kmer 20 -min_len_inter_kmer 8 -max_count_kmer 81	random	933	80	23	3	1039
NextPolish	-min_map_quality 7 -max_ins_fold_sgs 9 -max_clip_ratio_sgs 0.04 -trim_len_edge 0 -ext_len_edge 10 -indel_balance_factor_sgs 0.76 -min_count_ratio_skip 0.57 -max_len_kmer 109 -min_len_inter_kmer 8 -max_count_kmer 69	mutated	563	23	10	0	596
NextPolish	-min_map_quality 7 -max_ins_fold_sgs 3 -max_clip_ratio_sgs 0.25 -trim_len_edge 10 -ext_len_edge 3 -indel_balance_factor_sgs 0.97 -min_count_ratio_skip 0.43 -max_len_kmer 10 -min_len_inter_kmer 5 -max_count_kmer 63	random	824	62	21	0	907
NextPolish	-min_map_quality 7 -max_ins_fold_sgs 9 -max_clip_ratio_sgs 0.04 -trim_len_edge 0 -ext_len_edge 10 -indel_balance_factor_sgs 0.81 -min_count_ratio_skip 0.57 -max_len_kmer 109 -min_len_inter_kmer 8 -max_count_kmer 69	mutated	563	23	10	0	596
NextPolish	-min_map_quality 23 -max_ins_fold_sgs 7 -max_clip_ratio_sgs 0.9 -trim_len_edge 11 -ext_len_edge 0 -indel_balance_factor_sgs 0.59 -min_count_ratio_skip 0.58 -max_len_kmer 87 -min_len_inter_kmer 7 -max_count_kmer 51	random	696	35	15	0	746
NextPolish	-min_map_quality 7 -max_ins_fold_sgs 9 -max_clip_ratio_sgs 0.04 -trim_len_edge 0 -ext_len_edge 10 -indel_balance_factor_sgs 0.81 -min_count_ratio_skip 0.5 -max_len_kmer 109 -min_len_inter_kmer 8 -max_count_kmer 69	mutated	567	24	8	0	599
NextPolish	-min_map_quality 29 -max_ins_fold_sgs 4 -max_clip_ratio_sgs 0.53 -trim_len_edge 0 -ext_len_edge 11 -indel_balance_factor_sgs 0.67 -min_count_ratio_skip 0.91 -max_len_kmer 32 -min_len_inter_kmer 5 -max_count_kmer 80	random	957	88	22	3	1070
NextPolish	-min_map_quality 7 -max_ins_fold_sgs 7 -max_clip_ratio_sgs 0.04 -trim_len_edge 0 -ext_len_edge 10 -indel_balance_factor_sgs 0.81 -min_count_ratio_skip 0.57 -max_len_kmer 109 -min_len_inter_kmer 8 -max_count_kmer 69	mutated	563	23	10	0	596
NextPolish	-min_map_quality 29 -max_ins_fold_sgs 8 -max_clip_ratio_sgs 0.0 -trim_len_edge 16 -ext_len_edge 12 -indel_balance_factor_sgs 0.63 -min_count_ratio_skip 0.99 -max_len_kmer 34 -min_len_inter_kmer 4 -max_count_kmer 1	random	925	85	18	3	1031
NextPolish	-min_map_quality 7 -max_ins_fold_sgs 7 -max_clip_ratio_sgs 0.04 -trim_len_edge 0 -ext_len_edge 11 -indel_balance_factor_sgs 0.81 -min_count_ratio_skip 0.6 -max_len_kmer 109 -min_len_inter_kmer 8 -max_count_kmer 69	mutated	563	23	10	0	596
NextPolish	-min_map_quality 0 -max_ins_fold_sgs 6 -max_clip_ratio_sgs 0.86 -trim_len_edge 12 -ext_len_edge 1 -indel_balance_factor_sgs 0.02 -min_count_ratio_skip 0.16 -max_len_kmer 71 -min_len_inter_kmer 8 -max_count_kmer 50	random	918	97	30	0	1045
NextPolish	-min_map_quality 3 -max_ins_fold_sgs 8 -max_clip_ratio_sgs 0.04 -trim_len_edge 0 -ext_len_edge 11 -indel_balance_factor_sgs 0.81 -min_count_ratio_skip 0.6 -max_len_kmer 109 -min_len_inter_kmer 8 -max_count_kmer 69	mutated	563	23	10	0	596
NextPolish	-min_map_quality 54 -max_ins_fold_sgs 3 -max_clip_ratio_sgs 0.28 -trim_len_edge 1 -ext_len_edge 0 -indel_balance_factor_sgs 0.67 -min_count_ratio_skip 0.73 -max_len_kmer 12 -min_len_inter_kmer 10 -max_count_kmer 14	random	792	52	14	0	858
NextPolish	-min_map_quality 0 -max_ins_fold_sgs 8 -max_clip_ratio_sgs 0.04 -trim_len_edge 0 -ext_len_edge 11 -indel_balance_factor_sgs 0.81 -min_count_ratio_skip 0.58 -max_len_kmer 109 -min_len_inter_kmer 8 -max_count_kmer 69	mutated	563	23	10	0	596
NextPolish	-min_map_quality 14 -max_ins_fold_sgs 3 -max_clip_ratio_sgs 0.0 -trim_len_edge 2 -ext_len_edge 5 -indel_balance_factor_sgs 0.03 -min_count_ratio_skip 0.81 -max_len_kmer 21 -min_len_inter_kmer 6 -max_count_kmer 37	random	917	71	21	0	1009
NextPolish	-min_map_quality 23 -max_ins_fold_sgs 14 -max_clip_ratio_sgs 0.36 -trim_len_edge 5 -ext_len_edge 2 -indel_balance_factor_sgs 0.33 -min_count_ratio_skip 0.91 -max_len_kmer 81 -min_len_inter_kmer 3 -max_count_kmer 53	random	941	86	22	3	1052
NextPolish	-min_map_quality 0 -max_ins_fold_sgs 8 -max_clip_ratio_sgs 0.04 -trim_len_edge 0 -ext_len_edge 11 -indel_balance_factor_sgs 0.71 -min_count_ratio_skip 0.58 -max_len_kmer 109 -min_len_inter_kmer 8 -max_count_kmer 69	mutated	563	23	10	0	596
NextPolish	-min_map_quality 6 -max_ins_fold_sgs 8 -max_clip_ratio_sgs 0.03 -trim_len_edge 8 -ext_len_edge 0 -indel_balance_factor_sgs 0.68 -min_count_ratio_skip 0.53 -max_len_kmer 51 -min_len_inter_kmer 7 -max_count_kmer 26	random	677	36	15	0	728
NextPolish	-min_map_quality 0 -max_ins_fold_sgs 8 -max_clip_ratio_sgs 0.0 -trim_len_edge 0 -ext_len_edge 11 -indel_balance_factor_sgs 0.71 -min_count_ratio_skip 0.58 -max_len_kmer 109 -min_len_inter_kmer 8 -max_count_kmer 69	mutated	563	23	10	0	596
NextPolish	-min_map_quality 25 -max_ins_fold_sgs 3 -max_clip_ratio_sgs 0.29 -trim_len_edge 1 -ext_len_edge 8 -indel_balance_factor_sgs 0.14 -min_count_ratio_skip 0.82 -max_len_kmer 66 -min_len_inter_kmer 7 -max_count_kmer 79	random	910	71	20	0	1001
NextPolish	-min_map_quality 0 -max_ins_fold_sgs 8 -max_clip_ratio_sgs 0.0 -trim_len_edge 0 -ext_len_edge 11 -indel_balance_factor_sgs 0.71 -min_count_ratio_skip 0.66 -max_len_kmer 109 -min_len_inter_kmer 8 -max_count_kmer 69	mutated	575	25	11	0	611
NextPolish	-min_map_quality 59 -max_ins_fold_sgs 5 -max_clip_ratio_sgs 0.86 -trim_len_edge 25 -ext_len_edge 8 -indel_balance_factor_sgs 0.98 -min_count_ratio_skip 0.44 -max_len_kmer 39 -min_len_inter_kmer 9 -max_count_kmer 79	random	1381	265	81	21	1748
NextPolish	-min_map_quality 0 -max_ins_fold_sgs 8 -max_clip_ratio_sgs 0.0 -trim_len_edge 0 -ext_len_edge 11 -indel_balance_factor_sgs 0.71 -min_count_ratio_skip 0.58 -max_len_kmer 119 -min_len_inter_kmer 8 -max_count_kmer 69	mutated	563	23	10	0	596
NextPolish	-min_map_quality 17 -max_ins_fold_sgs 13 -max_clip_ratio_sgs 0.76 -trim_len_edge 3 -ext_len_edge 19 -indel_balance_factor_sgs 0.04 -min_count_ratio_skip 0.65 -max_len_kmer 20 -min_len_inter_kmer 9 -max_count_kmer 94	random	640	30	16	0	686
NextPolish	-min_map_quality 0 -max_ins_fold_sgs 8 -max_clip_ratio_sgs 0.0 -trim_len_edge 0 -ext_len_edge 11 -indel_balance_factor_sgs 0.71 -min_count_ratio_skip 0.58 -max_len_kmer 119 -min_len_inter_kmer 8 -max_count_kmer 73	mutated	563	23	10	0	596
NextPolish	-min_map_quality 6 -max_ins_fold_sgs 3 -max_clip_ratio_sgs 0.06 -trim_len_edge 0 -ext_len_edge 0 -indel_balance_factor_sgs 0.81 -min_count_ratio_skip 0.73 -max_len_kmer 36 -min_len_inter_kmer 3 -max_count_kmer 79	random	778	47	13	0	838
NextPolish	-min_map_quality 46 -max_ins_fold_sgs 15 -max_clip_ratio_sgs 0.22 -trim_len_edge 3 -ext_len_edge 14 -indel_balance_factor_sgs 0.73 -min_count_ratio_skip 0.39 -max_len_kmer 56 -min_len_inter_kmer 8 -max_count_kmer 74	random	633	29	12	0	674
NextPolish	-min_map_quality 0 -max_ins_fold_sgs 8 -max_clip_ratio_sgs 0.01 -trim_len_edge 0 -ext_len_edge 11 -indel_balance_factor_sgs 0.71 -min_count_ratio_skip 0.58 -max_len_kmer 119 -min_len_inter_kmer 8 -max_count_kmer 73	mutated	563	23	10	0	596
NextPolish	-min_map_quality 9 -max_ins_fold_sgs 1 -max_clip_ratio_sgs 0.01 -trim_len_edge 1 -ext_len_edge 2 -indel_balance_factor_sgs 0.17 -min_count_ratio_skip 0.66 -max_len_kmer 71 -min_len_inter_kmer 9 -max_count_kmer 100	random	593	23	13	0	629
NextPolish	-min_map_quality 0 -max_ins_fold_sgs 8 -max_clip_ratio_sgs 0.01 -trim_len_edge 0 -ext_len_edge 9 -indel_balance_factor_sgs 0.71 -min_count_ratio_skip 0.58 -max_len_kmer 119 -min_len_inter_kmer 8 -max_count_kmer 73	mutated	563	23	10	0	596
NextPolish	-min_map_quality 53 -max_ins_fold_sgs 5 -max_clip_ratio_sgs 0.04 -trim_len_edge 5 -ext_len_edge 0 -indel_balance_factor_sgs 0.02 -min_count_ratio_skip 0.87 -max_len_kmer 22 -min_len_inter_kmer 6 -max_count_kmer 17	random	935	80	22	3	1040
NextPolish	-min_map_quality 0 -max_ins_fold_sgs 8 -max_clip_ratio_sgs 0.01 -trim_len_edge 0 -ext_len_edge 9 -indel_balance_factor_sgs 0.71 -min_count_ratio_skip 0.57 -max_len_kmer 119 -min_len_inter_kmer 8 -max_count_kmer 73	mutated	563	23	10	0	596
NextPolish	-min_map_quality 13 -max_ins_fold_sgs 13 -max_clip_ratio_sgs 0.5 -trim_len_edge 17 -ext_len_edge 1 -indel_balance_factor_sgs 0.58 -min_count_ratio_skip 0.9 -max_len_kmer 27 -min_len_inter_kmer 4 -max_count_kmer 32	random	923	86	18	5	1032
NextPolish	-min_map_quality 0 -max_ins_fold_sgs 8 -max_clip_ratio_sgs 0.01 -trim_len_edge 0 -ext_len_edge 9 -indel_balance_factor_sgs 0.71 -min_count_ratio_skip 0.57 -max_len_kmer 119 -min_len_inter_kmer 8 -max_count_kmer 71	mutated	563	23	10	0	596
NextPolish	-min_map_quality 27 -max_ins_fold_sgs 2 -max_clip_ratio_sgs 0.11 -trim_len_edge 17 -ext_len_edge 1 -indel_balance_factor_sgs 0.19 -min_count_ratio_skip 0.83 -max_len_kmer 49 -min_len_inter_kmer 2 -max_count_kmer 96	random	918	84	18	4	1024
NextPolish	-min_map_quality 0 -max_ins_fold_sgs 6 -max_clip_ratio_sgs 0.01 -trim_len_edge 0 -ext_len_edge 9 -indel_balance_factor_sgs 0.71 -min_count_ratio_skip 0.57 -max_len_kmer 119 -min_len_inter_kmer 8 -max_count_kmer 81	mutated	563	23	10	0	596
NextPolish	-min_map_quality 26 -max_ins_fold_sgs 10 -max_clip_ratio_sgs 0.0 -trim_len_edge 3 -ext_len_edge 4 -indel_balance_factor_sgs 0.59 -min_count_ratio_skip 0.99 -max_len_kmer 52 -min_len_inter_kmer 6 -max_count_kmer 88	random	944	88	23	4	1059
NextPolish	-min_map_quality 0 -max_ins_fold_sgs 6 -max_clip_ratio_sgs 0.01 -trim_len_edge 0 -ext_len_edge 9 -indel_balance_factor_sgs 0.71 -min_count_ratio_skip 0.57 -max_len_kmer 119 -min_len_inter_kmer 6 -max_count_kmer 81	mutated	563	23	10	0	596
NextPolish	-min_map_quality 2 -max_ins_fold_sgs 9 -max_clip_ratio_sgs 0.59 -trim_len_edge 25 -ext_len_edge 0 -indel_balance_factor_sgs 0.57 -min_count_ratio_skip 0.61 -max_len_kmer 90 -min_len_inter_kmer 4 -max_count_kmer 7	random	785	66	20	1	872
NextPolish	-min_map_quality 3 -max_ins_fold_sgs 5 -max_clip_ratio_sgs 0.04 -trim_len_edge 5 -ext_len_edge 14 -indel_balance_factor_sgs 0.58 -min_count_ratio_skip 0.77 -max_len_kmer 83 -min_len_inter_kmer 2 -max_count_kmer 63	random	911	67	23	0	1001
NextPolish	-min_map_quality 56 -max_ins_fold_sgs 13 -max_clip_ratio_sgs 0.16 -trim_len_edge 1 -ext_len_edge 7 -indel_balance_factor_sgs 0.6 -min_count_ratio_skip 0.52 -max_len_kmer 98 -min_len_inter_kmer 8 -max_count_kmer 67	random	583	22	12	0	617
NextPolish	-min_map_quality 2 -max_ins_fold_sgs 4 -max_clip_ratio_sgs 0.45 -trim_len_edge 0 -ext_len_edge 0 -indel_balance_factor_sgs 0.34 -min_count_ratio_skip 0.92 -max_len_kmer 43 -min_len_inter_kmer 10 -max_count_kmer 40	random	957	91	22	3	1073
NextPolish	-min_map_quality 0 -max_ins_fold_sgs 8 -max_clip_ratio_sgs 0.01 -trim_len_edge 0 -ext_len_edge 9 -indel_balance_factor_sgs 0.71 -min_count_ratio_skip 0.57 -max_len_kmer 119 -min_len_inter_kmer 6 -max_count_kmer 81	mutated	563	23	10	0	596
NextPolish	-min_map_quality 0 -max_ins_fold_sgs 2 -max_clip_ratio_sgs 0.18 -trim_len_edge 1 -ext_len_edge 4 -indel_balance_factor_sgs 0.22 -min_count_ratio_skip 0.69 -max_len_kmer 45 -min_len_inter_kmer 7 -max_count_kmer 64	random	791	51	14	0	856
NextPolish	-min_map_quality 2 -max_ins_fold_sgs 1 -max_clip_ratio_sgs 0.0 -trim_len_edge 1 -ext_len_edge 1 -indel_balance_factor_sgs 0.64 -min_count_ratio_skip 0.29 -max_len_kmer 35 -min_len_inter_kmer 2 -max_count_kmer 97	random	586	23	9	0	618
NextPolish	-min_map_quality 0 -max_ins_fold_sgs 8 -max_clip_ratio_sgs 0.09 -trim_len_edge 0 -ext_len_edge 9 -indel_balance_factor_sgs 0.71 -min_count_ratio_skip 0.57 -max_len_kmer 119 -min_len_inter_kmer 6 -max_count_kmer 81	mutated	563	23	10	0	596
NextPolish	-min_map_quality 24 -max_ins_fold_sgs 1 -max_clip_ratio_sgs 0.25 -trim_len_edge 1 -ext_len_edge 15 -indel_balance_factor_sgs 0.03 -min_count_ratio_skip 0.7 -max_len_kmer 39 -min_len_inter_kmer 7 -max_count_kmer 75	random	791	51	14	0	856
NextPolish	-min_map_quality 0 -max_ins_fold_sgs 8 -max_clip_ratio_sgs 0.09 -trim_len_edge 0 -ext_len_edge 9 -indel_balance_factor_sgs 0.71 -min_count_ratio_skip 0.57 -max_len_kmer 119 -min_len_inter_kmer 4 -max_count_kmer 81	mutated	563	23	10	0	596
NextPolish	-min_map_quality 58 -max_ins_fold_sgs 7 -max_clip_ratio_sgs 0.37 -trim_len_edge 2 -ext_len_edge 0 -indel_balance_factor_sgs 0.8 -min_count_ratio_skip 0.42 -max_len_kmer 64 -min_len_inter_kmer 2 -max_count_kmer 96	random	603	25	11	0	639
NextPolish	-min_map_quality 0 -max_ins_fold_sgs 6 -max_clip_ratio_sgs 0.09 -trim_len_edge 0 -ext_len_edge 9 -indel_balance_factor_sgs 0.71 -min_count_ratio_skip 0.57 -max_len_kmer 119 -min_len_inter_kmer 4 -max_count_kmer 81	mutated	563	23	10	0	596
NextPolish	-min_map_quality 35 -max_ins_fold_sgs 14 -max_clip_ratio_sgs 0.31 -trim_len_edge 19 -ext_len_edge 0 -indel_balance_factor_sgs 0.87 -min_count_ratio_skip 0.24 -max_len_kmer 50 -min_len_inter_kmer 3 -max_count_kmer 96	random	1224	193	54	14	1485
NextPolish	-min_map_quality 0 -max_ins_fold_sgs 8 -max_clip_ratio_sgs 0.09 -trim_len_edge 0 -ext_len_edge 9 -indel_balance_factor_sgs 0.65 -min_count_ratio_skip 0.57 -max_len_kmer 119 -min_len_inter_kmer 4 -max_count_kmer 81	mutated	563	23	10	0	596
NextPolish	-min_map_quality 6 -max_ins_fold_sgs 3 -max_clip_ratio_sgs 0.04 -trim_len_edge 24 -ext_len_edge 27 -indel_balance_factor_sgs 0.81 -min_count_ratio_skip 0.46 -max_len_kmer 66 -min_len_inter_kmer 10 -max_count_kmer 7	random	1357	248	70	17	1692
NextPolish	-min_map_quality 32 -max_ins_fold_sgs 10 -max_clip_ratio_sgs 0.3 -trim_len_edge 0 -ext_len_edge 1 -indel_balance_factor_sgs 0.39 -min_count_ratio_skip 0.64 -max_len_kmer 92 -min_len_inter_kmer 4 -max_count_kmer 88	random	575	25	11	0	611
NextPolish	-min_map_quality 0 -max_ins_fold_sgs 8 -max_clip_ratio_sgs 0.06 -trim_len_edge 1 -ext_len_edge 9 -indel_balance_factor_sgs 0.65 -min_count_ratio_skip 0.57 -max_len_kmer 119 -min_len_inter_kmer 4 -max_count_kmer 81	mutated	583	22	12	0	617
NextPolish	-min_map_quality 9 -max_ins_fold_sgs 6 -max_clip_ratio_sgs 0.51 -trim_len_edge 24 -ext_len_edge 0 -indel_balance_factor_sgs 0.95 -min_count_ratio_skip 0.88 -max_len_kmer 93 -min_len_inter_kmer 7 -max_count_kmer 89	random	907	86	22	3	1018
NextPolish	-min_map_quality 0 -max_ins_fold_sgs 8 -max_clip_ratio_sgs 0.09 -trim_len_edge 0 -ext_len_edge 9 -indel_balance_factor_sgs 0.65 -min_count_ratio_skip 0.57 -max_len_kmer 119 -min_len_inter_kmer 5 -max_count_kmer 81	mutated	563	23	10	0	596
NextPolish	-min_map_quality 58 -max_ins_fold_sgs 4 -max_clip_ratio_sgs 0.65 -trim_len_edge 10 -ext_len_edge 7 -indel_balance_factor_sgs 0.65 -min_count_ratio_skip 0.97 -max_len_kmer 78 -min_len_inter_kmer 6 -max_count_kmer 90	random	917	80	19	3	1019
NextPolish	-min_map_quality 0 -max_ins_fold_sgs 8 -max_clip_ratio_sgs 0.08 -trim_len_edge 0 -ext_len_edge 8 -indel_balance_factor_sgs 0.65 -min_count_ratio_skip 0.6 -max_len_kmer 119 -min_len_inter_kmer 5 -max_count_kmer 81	mutated	563	23	10	0	596
NextPolish	-min_map_quality 0 -max_ins_fold_sgs 7 -max_clip_ratio_sgs 0.0 -trim_len_edge 8 -ext_len_edge 22 -indel_balance_factor_sgs 0.19 -min_count_ratio_skip 0.53 -max_len_kmer 38 -min_len_inter_kmer 6 -max_count_kmer 80	random	677	36	15	0	728
NextPolish	-min_map_quality 60 -max_ins_fold_sgs 1 -max_clip_ratio_sgs 0.11 -trim_len_edge 3 -ext_len_edge 7 -indel_balance_factor_sgs 0.96 -min_count_ratio_skip 0.73 -max_len_kmer 62 -min_len_inter_kmer 8 -max_count_kmer 8	random	830	56	18	0	904
NextPolish	-min_map_quality 58 -max_ins_fold_sgs 12 -max_clip_ratio_sgs 0.72 -trim_len_edge 7 -ext_len_edge 0 -indel_balance_factor_sgs 0.44 -min_count_ratio_skip 0.68 -max_len_kmer 31 -min_len_inter_kmer 7 -max_count_kmer 98	random	857	59	21	0	937
NextPolish	-min_map_quality 0 -max_ins_fold_sgs 8 -max_clip_ratio_sgs 0.08 -trim_len_edge 0 -ext_len_edge 8 -indel_balance_factor_sgs 0.69 -min_count_ratio_skip 0.6 -max_len_kmer 119 -min_len_inter_kmer 5 -max_count_kmer 74	mutated	563	23	10	0	596
NextPolish	-min_map_quality 47 -max_ins_fold_sgs 6 -max_clip_ratio_sgs 0.0 -trim_len_edge 8 -ext_len_edge 17 -indel_balance_factor_sgs 0.9 -min_count_ratio_skip 0.12 -max_len_kmer 43 -min_len_inter_kmer 3 -max_count_kmer 54	random	784	57	18	0	859
NextPolish	-min_map_quality 0 -max_ins_fold_sgs 6 -max_clip_ratio_sgs 0.08 -trim_len_edge 0 -ext_len_edge 8 -indel_balance_factor_sgs 0.69 -min_count_ratio_skip 0.6 -max_len_kmer 119 -min_len_inter_kmer 5 -max_count_kmer 74	mutated	563	23	10	0	596
NextPolish	-min_map_quality 52 -max_ins_fold_sgs 7 -max_clip_ratio_sgs 0.14 -trim_len_edge 6 -ext_len_edge 0 -indel_balance_factor_sgs 0.62 -min_count_ratio_skip 0.92 -max_len_kmer 68 -min_len_inter_kmer 9 -max_count_kmer 3	random	938	86	22	3	1049
NextPolish	-min_map_quality 0 -max_ins_fold_sgs 6 -max_clip_ratio_sgs 0.08 -trim_len_edge 0 -ext_len_edge 7 -indel_balance_factor_sgs 0.69 -min_count_ratio_skip 0.6 -max_len_kmer 119 -min_len_inter_kmer 7 -max_count_kmer 74	mutated	563	23	10	0	596
NextPolish	-min_map_quality 8 -max_ins_fold_sgs 3 -max_clip_ratio_sgs 0.66 -trim_len_edge 4 -ext_len_edge 0 -indel_balance_factor_sgs 0.28 -min_count_ratio_skip 0.75 -max_len_kmer 64 -min_len_inter_kmer 3 -max_count_kmer 21	random	843	58	18	0	919
NextPolish	-min_map_quality 52 -max_ins_fold_sgs 15 -max_clip_ratio_sgs 0.24 -trim_len_edge 13 -ext_len_edge 20 -indel_balance_factor_sgs 0.47 -min_count_ratio_skip 0.79 -max_len_kmer 65 -min_len_inter_kmer 9 -max_count_kmer 74	random	880	74	20	3	977
NextPolish	-min_map_quality 0 -max_ins_fold_sgs 6 -max_clip_ratio_sgs 0.06 -trim_len_edge 0 -ext_len_edge 7 -indel_balance_factor_sgs 0.69 -min_count_ratio_skip 0.6 -max_len_kmer 119 -min_len_inter_kmer 7 -max_count_kmer 74	mutated	563	23	10	0	596
NextPolish	-min_map_quality 58 -max_ins_fold_sgs 11 -max_clip_ratio_sgs 0.44 -trim_len_edge 17 -ext_len_edge 13 -indel_balance_factor_sgs 0.45 -min_count_ratio_skip 0.84 -max_len_kmer 33 -min_len_inter_kmer 8 -max_count_kmer 86	random	922	86	18	4	1030
NextPolish	-min_map_quality 27 -max_ins_fold_sgs 2 -max_clip_ratio_sgs 0.02 -trim_len_edge 1 -ext_len_edge 7 -indel_balance_factor_sgs 0.41 -min_count_ratio_skip 0.39 -max_len_kmer 87 -min_len_inter_kmer 1 -max_count_kmer 48	random	586	23	10	0	619
NextPolish	-min_map_quality 0 -max_ins_fold_sgs 6 -max_clip_ratio_sgs 0.06 -trim_len_edge 2 -ext_len_edge 7 -indel_balance_factor_sgs 0.69 -min_count_ratio_skip 0.55 -max_len_kmer 119 -min_len_inter_kmer 7 -max_count_kmer 74	mutated	601	25	13	0	639
NextPolish	-min_map_quality 56 -max_ins_fold_sgs 5 -max_clip_ratio_sgs 0.0 -trim_len_edge 0 -ext_len_edge 4 -indel_balance_factor_sgs 0.58 -min_count_ratio_skip 0.67 -max_len_kmer 79 -min_len_inter_kmer 1 -max_count_kmer 53	random	777	46	13	0	836
NextPolish	-min_map_quality 8 -max_ins_fold_sgs 6 -max_clip_ratio_sgs 0.06 -trim_len_edge 0 -ext_len_edge 7 -indel_balance_factor_sgs 0.69 -min_count_ratio_skip 0.61 -max_len_kmer 119 -min_len_inter_kmer 7 -max_count_kmer 74	mutated	575	25	11	0	611
NextPolish	-min_map_quality 54 -max_ins_fold_sgs 9 -max_clip_ratio_sgs 0.0 -trim_len_edge 2 -ext_len_edge 0 -indel_balance_factor_sgs 0.59 -min_count_ratio_skip 0.56 -max_len_kmer 40 -min_len_inter_kmer 10 -max_count_kmer 32	random	601	25	13	0	639
NextPolish	-min_map_quality 16 -max_ins_fold_sgs 10 -max_clip_ratio_sgs 0.0 -trim_len_edge 16 -ext_len_edge 0 -indel_balance_factor_sgs 0.5 -min_count_ratio_skip 0.9 -max_len_kmer 24 -min_len_inter_kmer 4 -max_count_kmer 93	random	925	85	18	3	1031
NextPolish	-min_map_quality 0 -max_ins_fold_sgs 6 -max_clip_ratio_sgs 0.06 -trim_len_edge 0 -ext_len_edge 7 -indel_balance_factor_sgs 0.69 -min_count_ratio_skip 0.68 -max_len_kmer 119 -min_len_inter_kmer 7 -max_count_kmer 74	mutated	777	46	13	0	836
NextPolish	-min_map_quality 11 -max_ins_fold_sgs 6 -max_clip_ratio_sgs 0.81 -trim_len_edge 9 -ext_len_edge 16 -indel_balance_factor_sgs 0.59 -min_count_ratio_skip 0.97 -max_len_kmer 40 -min_len_inter_kmer 4 -max_count_kmer 98	random	920	79	18	3	1020
NextPolish	-min_map_quality 0 -max_ins_fold_sgs 6 -max_clip_ratio_sgs 0.09 -trim_len_edge 0 -ext_len_edge 7 -indel_balance_factor_sgs 0.69 -min_count_ratio_skip 0.58 -max_len_kmer 119 -min_len_inter_kmer 7 -max_count_kmer 67	mutated	563	23	10	0	596
NextPolish	-min_map_quality 36 -max_ins_fold_sgs 6 -max_clip_ratio_sgs 0.46 -trim_len_edge 16 -ext_len_edge 3 -indel_balance_factor_sgs 0.39 -min_count_ratio_skip 0.92 -max_len_kmer 56 -min_len_inter_kmer 9 -max_count_kmer 4	random	925	85	18	3	1031
NextPolish	-min_map_quality 0 -max_ins_fold_sgs 6 -max_clip_ratio_sgs 0.09 -trim_len_edge 0 -ext_len_edge 7 -indel_balance_factor_sgs 0.66 -min_count_ratio_skip 0.58 -max_len_kmer 119 -min_len_inter_kmer 7 -max_count_kmer 67	mutated	563	23	10	0	596
NextPolish	-min_map_quality 0 -max_ins_fold_sgs 10 -max_clip_ratio_sgs 0.43 -trim_len_edge 0 -ext_len_edge 0 -indel_balance_factor_sgs 0.88 -min_count_ratio_skip 0.86 -max_len_kmer 16 -min_len_inter_kmer 7 -max_count_kmer 52	random	940	84	20	3	1047
NextPolish	-min_map_quality 21 -max_ins_fold_sgs 16 -max_clip_ratio_sgs 0.79 -trim_len_edge 25 -ext_len_edge 5 -indel_balance_factor_sgs 0.82 -min_count_ratio_skip 0.7 -max_len_kmer 69 -min_len_inter_kmer 6 -max_count_kmer 91	random	889	76	21	1	987
NextPolish	-min_map_quality 0 -max_ins_fold_sgs 6 -max_clip_ratio_sgs 0.09 -trim_len_edge 0 -ext_len_edge 7 -indel_balance_factor_sgs 0.66 -min_count_ratio_skip 0.49 -max_len_kmer 119 -min_len_inter_kmer 7 -max_count_kmer 67	mutated	567	24	8	0	599
NextPolish	-min_map_quality 10 -max_ins_fold_sgs 14 -max_clip_ratio_sgs 0.04 -trim_len_edge 1 -ext_len_edge 8 -indel_balance_factor_sgs 0.78 -min_count_ratio_skip 0.93 -max_len_kmer 41 -min_len_inter_kmer 6 -max_count_kmer 22	random	946	89	21	3	1059
NextPolish	-min_map_quality 0 -max_ins_fold_sgs 8 -max_clip_ratio_sgs 0.09 -trim_len_edge 0 -ext_len_edge 7 -indel_balance_factor_sgs 0.66 -min_count_ratio_skip 0.49 -max_len_kmer 119 -min_len_inter_kmer 7 -max_count_kmer 76	mutated	567	24	8	0	599
NextPolish	-min_map_quality 5 -max_ins_fold_sgs 7 -max_clip_ratio_sgs 0.13 -trim_len_edge 13 -ext_len_edge 2 -indel_balance_factor_sgs 0.81 -min_count_ratio_skip 0.31 -max_len_kmer 76 -min_len_inter_kmer 9 -max_count_kmer 32	random	961	109	36	0	1106
NextPolish	-min_map_quality 0 -max_ins_fold_sgs 8 -max_clip_ratio_sgs 0.09 -trim_len_edge 1 -ext_len_edge 7 -indel_balance_factor_sgs 0.66 -min_count_ratio_skip 0.49 -max_len_kmer 119 -min_len_inter_kmer 7 -max_count_kmer 67	mutated	585	23	10	0	618
NextPolish	-min_map_quality 60 -max_ins_fold_sgs 4 -max_clip_ratio_sgs 0.01 -trim_len_edge 0 -ext_len_edge 3 -indel_balance_factor_sgs 0.44 -min_count_ratio_skip 0.28 -max_len_kmer 87 -min_len_inter_kmer 8 -max_count_kmer 5	random	564	24	8	0	596
NextPolish	-min_map_quality 60 -max_ins_fold_sgs 4 -max_clip_ratio_sgs 0.0 -trim_len_edge 2 -ext_len_edge 4 -indel_balance_factor_sgs 0.44 -min_count_ratio_skip 0.28 -max_len_kmer 80 -min_len_inter_kmer 8 -max_count_kmer 5	mutated	602	25	11	0	638
NextPolish	-min_map_quality 30 -max_ins_fold_sgs 1 -max_clip_ratio_sgs 0.0 -trim_len_edge 10 -ext_len_edge 0 -indel_balance_factor_sgs 0.35 -min_count_ratio_skip 0.33 -max_len_kmer 26 -min_len_inter_kmer 7 -max_count_kmer 66	random	848	72	24	0	944
NextPolish	-min_map_quality 21 -max_ins_fold_sgs 4 -max_clip_ratio_sgs 0.49 -trim_len_edge 10 -ext_len_edge 9 -indel_balance_factor_sgs 0.15 -min_count_ratio_skip 0.66 -max_len_kmer 35 -min_len_inter_kmer 9 -max_count_kmer 79	random	702	36	15	0	753
NextPolish	-min_map_quality 60 -max_ins_fold_sgs 5 -max_clip_ratio_sgs 0.01 -trim_len_edge 1 -ext_len_edge 3 -indel_balance_factor_sgs 0.44 -min_count_ratio_skip 0.28 -max_len_kmer 87 -min_len_inter_kmer 8 -max_count_kmer 1	mutated	586	23	9	0	618
NextPolish	-min_map_quality 36 -max_ins_fold_sgs 3 -max_clip_ratio_sgs 0.0 -trim_len_edge 4 -ext_len_edge 3 -indel_balance_factor_sgs 0.65 -min_count_ratio_skip 0.9 -max_len_kmer 76 -min_len_inter_kmer 5 -max_count_kmer 98	random	939	86	23	3	1051
NextPolish	-min_map_quality 51 -max_ins_fold_sgs 4 -max_clip_ratio_sgs 0.01 -trim_len_edge 0 -ext_len_edge 3 -indel_balance_factor_sgs 0.44 -min_count_ratio_skip 0.28 -max_len_kmer 87 -min_len_inter_kmer 8 -max_count_kmer 5	mutated	564	24	8	0	596
NextPolish	-min_map_quality 9 -max_ins_fold_sgs 1 -max_clip_ratio_sgs 0.35 -trim_len_edge 5 -ext_len_edge 9 -indel_balance_factor_sgs 0.21 -min_count_ratio_skip 0.77 -max_len_kmer 81 -min_len_inter_kmer 6 -max_count_kmer 81	random	911	67	23	0	1001
NextPolish	-min_map_quality 51 -max_ins_fold_sgs 4 -max_clip_ratio_sgs 0.01 -trim_len_edge 0 -ext_len_edge 3 -indel_balance_factor_sgs 0.44 -min_count_ratio_skip 0.28 -max_len_kmer 87 -min_len_inter_kmer 8 -max_count_kmer 1	mutated	564	24	8	0	596
NextPolish	-min_map_quality 1 -max_ins_fold_sgs 7 -max_clip_ratio_sgs 0.04 -trim_len_edge 0 -ext_len_edge 19 -indel_balance_factor_sgs 0.68 -min_count_ratio_skip 0.25 -max_len_kmer 64 -min_len_inter_kmer 3 -max_count_kmer 7	random	566	24	8	0	598
NextPolish	-min_map_quality 51 -max_ins_fold_sgs 4 -max_clip_ratio_sgs 0.0 -trim_len_edge 0 -ext_len_edge 2 -indel_balance_factor_sgs 0.44 -min_count_ratio_skip 0.28 -max_len_kmer 87 -min_len_inter_kmer 7 -max_count_kmer 1	mutated	564	24	8	0	596
NextPolish	-min_map_quality 54 -max_ins_fold_sgs 8 -max_clip_ratio_sgs 0.63 -trim_len_edge 1 -ext_len_edge 2 -indel_balance_factor_sgs 0.17 -min_count_ratio_skip 0.1 -max_len_kmer 11 -min_len_inter_kmer 9 -max_count_kmer 59	random	588	23	9	0	620
NextPolish	-min_map_quality 51 -max_ins_fold_sgs 4 -max_clip_ratio_sgs 0.0 -trim_len_edge 0 -ext_len_edge 2 -indel_balance_factor_sgs 0.44 -min_count_ratio_skip 0.28 -max_len_kmer 94 -min_len_inter_kmer 7 -max_count_kmer 1	mutated	564	24	8	0	596
NextPolish	-min_map_quality 56 -max_ins_fold_sgs 5 -max_clip_ratio_sgs 0.02 -trim_len_edge 15 -ext_len_edge 0 -indel_balance_factor_sgs 0.62 -min_count_ratio_skip 0.69 -max_len_kmer 35 -min_len_inter_kmer 4 -max_count_kmer 62	random	861	70	17	0	948
NextPolish	-min_map_quality 20 -max_ins_fold_sgs 15 -max_clip_ratio_sgs 0.01 -trim_len_edge 0 -ext_len_edge 0 -indel_balance_factor_sgs 0.71 -min_count_ratio_skip 0.81 -max_len_kmer 16 -min_len_inter_kmer 5 -max_count_kmer 22	random	909	72	17	0	998
NextPolish	-min_map_quality 43 -max_ins_fold_sgs 4 -max_clip_ratio_sgs 0.05 -trim_len_edge 0 -ext_len_edge 3 -indel_balance_factor_sgs 0.44 -min_count_ratio_skip 0.21 -max_len_kmer 94 -min_len_inter_kmer 7 -max_count_kmer 1	mutated	566	24	8	0	598
NextPolish	-min_map_quality 5 -max_ins_fold_sgs 5 -max_clip_ratio_sgs 0.03 -trim_len_edge 21 -ext_len_edge 3 -indel_balance_factor_sgs 0.42 -min_count_ratio_skip 0.78 -max_len_kmer 46 -min_len_inter_kmer 5 -max_count_kmer 80	random	880	77	23	4	984
NextPolish	-min_map_quality 21 -max_ins_fold_sgs 2 -max_clip_ratio_sgs 0.0 -trim_len_edge 0 -ext_len_edge 21 -indel_balance_factor_sgs 0.82 -min_count_ratio_skip 0.83 -max_len_kmer 92 -min_len_inter_kmer 1 -max_count_kmer 61	random	909	72	17	0	998
NextPolish	-min_map_quality 51 -max_ins_fold_sgs 4 -max_clip_ratio_sgs 0.0 -trim_len_edge 0 -ext_len_edge 2 -indel_balance_factor_sgs 0.44 -min_count_ratio_skip 0.3 -max_len_kmer 94 -min_len_inter_kmer 7 -max_count_kmer 1	mutated	564	24	8	0	596
NextPolish	-min_map_quality 45 -max_ins_fold_sgs 14 -max_clip_ratio_sgs 0.0 -trim_len_edge 7 -ext_len_edge 2 -indel_balance_factor_sgs 0.31 -min_count_ratio_skip 0.97 -max_len_kmer 45 -min_len_inter_kmer 8 -max_count_kmer 71	random	928	84	22	3	1037
NextPolish	-min_map_quality 51 -max_ins_fold_sgs 4 -max_clip_ratio_sgs 0.0 -trim_len_edge 0 -ext_len_edge 2 -indel_balance_factor_sgs 0.44 -min_count_ratio_skip 0.29 -max_len_kmer 99 -min_len_inter_kmer 7 -max_count_kmer 1	mutated	564	24	8	0	596
NextPolish	-min_map_quality 44 -max_ins_fold_sgs 12 -max_clip_ratio_sgs 0.51 -trim_len_edge 0 -ext_len_edge 26 -indel_balance_factor_sgs 0.67 -min_count_ratio_skip 0.65 -max_len_kmer 85 -min_len_inter_kmer 7 -max_count_kmer 48	random	575	25	11	0	611
NextPolish	-min_map_quality 51 -max_ins_fold_sgs 4 -max_clip_ratio_sgs 0.0 -trim_len_edge 0 -ext_len_edge 2 -indel_balance_factor_sgs 0.44 -min_count_ratio_skip 0.29 -max_len_kmer 99 -min_len_inter_kmer 5 -max_count_kmer 1	mutated	564	24	8	0	596
NextPolish	-min_map_quality 45 -max_ins_fold_sgs 3 -max_clip_ratio_sgs 0.57 -trim_len_edge 1 -ext_len_edge 1 -indel_balance_factor_sgs 0.55 -min_count_ratio_skip 0.74 -max_len_kmer 96 -min_len_inter_kmer 2 -max_count_kmer 4	random	792	52	14	0	858
NextPolish	-min_map_quality 51 -max_ins_fold_sgs 6 -max_clip_ratio_sgs 0.0 -trim_len_edge 0 -ext_len_edge 2 -indel_balance_factor_sgs 0.42 -min_count_ratio_skip 0.29 -max_len_kmer 99 -min_len_inter_kmer 5 -max_count_kmer 1	mutated	564	24	8	0	596
NextPolish	-min_map_quality 32 -max_ins_fold_sgs 10 -max_clip_ratio_sgs 0.31 -trim_len_edge 3 -ext_len_edge 11 -indel_balance_factor_sgs 0.98 -min_count_ratio_skip 0.9 -max_len_kmer 31 -min_len_inter_kmer 7 -max_count_kmer 36	random	944	86	23	3	1056
NextPolish	-min_map_quality 39 -max_ins_fold_sgs 2 -max_clip_ratio_sgs 0.0 -trim_len_edge 26 -ext_len_edge 1 -indel_balance_factor_sgs 0.53 -min_count_ratio_skip 0.83 -max_len_kmer 82 -min_len_inter_kmer 6 -max_count_kmer 87	random	914	84	23	4	1025
NextPolish	-min_map_quality 51 -max_ins_fold_sgs 7 -max_clip_ratio_sgs 0.0 -trim_len_edge 0 -ext_len_edge 2 -indel_balance_factor_sgs 0.42 -min_count_ratio_skip 0.29 -max_len_kmer 99 -min_len_inter_kmer 5 -max_count_kmer 1	mutated	564	24	8	0	596
NextPolish	-min_map_quality 30 -max_ins_fold_sgs 12 -max_clip_ratio_sgs 0.42 -trim_len_edge 20 -ext_len_edge 18 -indel_balance_factor_sgs 0.61 -min_count_ratio_skip 0.9 -max_len_kmer 23 -min_len_inter_kmer 10 -max_count_kmer 13	random	900	79	22	4	1005
NextPolish	-min_map_quality 51 -max_ins_fold_sgs 7 -max_clip_ratio_sgs 0.0 -trim_len_edge 0 -ext_len_edge 4 -indel_balance_factor_sgs 0.42 -min_count_ratio_skip 0.29 -max_len_kmer 99 -min_len_inter_kmer 5 -max_count_kmer 1	mutated	564	24	8	0	596
NextPolish	-min_map_quality 25 -max_ins_fold_sgs 16 -max_clip_ratio_sgs 0.65 -trim_len_edge 0 -ext_len_edge 0 -indel_balance_factor_sgs 0.33 -min_count_ratio_skip 0.63 -max_len_kmer 84 -min_len_inter_kmer 7 -max_count_kmer 100	random	575	25	11	0	611
NextPolish	-min_map_quality 2 -max_ins_fold_sgs 14 -max_clip_ratio_sgs 0.0 -trim_len_edge 0 -ext_len_edge 0 -indel_balance_factor_sgs 0.01 -min_count_ratio_skip 0.66 -max_len_kmer 63 -min_len_inter_kmer 2 -max_count_kmer 53	random	575	25	11	0	611
NextPolish	-min_map_quality 51 -max_ins_fold_sgs 7 -max_clip_ratio_sgs 0.0 -trim_len_edge 0 -ext_len_edge 4 -indel_balance_factor_sgs 0.42 -min_count_ratio_skip 0.29 -max_len_kmer 99 -min_len_inter_kmer 5 -max_count_kmer 6	mutated	564	24	8	0	596
NextPolish	-min_map_quality 53 -max_ins_fold_sgs 4 -max_clip_ratio_sgs 0.44 -trim_len_edge 1 -ext_len_edge 2 -indel_balance_factor_sgs 0.86 -min_count_ratio_skip 0.31 -max_len_kmer 100 -min_len_inter_kmer 4 -max_count_kmer 48	random	586	23	9	0	618
NextPolish	-min_map_quality 51 -max_ins_fold_sgs 7 -max_clip_ratio_sgs 0.0 -trim_len_edge 0 -ext_len_edge 4 -indel_balance_factor_sgs 0.39 -min_count_ratio_skip 0.29 -max_len_kmer 99 -min_len_inter_kmer 5 -max_count_kmer 6	mutated	564	24	8	0	596
NextPolish	-min_map_quality 6 -max_ins_fold_sgs 5 -max_clip_ratio_sgs 0.67 -trim_len_edge 0 -ext_len_edge 4 -indel_balance_factor_sgs 0.58 -min_count_ratio_skip 0.35 -max_len_kmer 98 -min_len_inter_kmer 5 -max_count_kmer 52	random	569	24	8	0	601
NextPolish	-min_map_quality 51 -max_ins_fold_sgs 7 -max_clip_ratio_sgs 0.0 -trim_len_edge 0 -ext_len_edge 4 -indel_balance_factor_sgs 0.39 -min_count_ratio_skip 0.3 -max_len_kmer 99 -min_len_inter_kmer 5 -max_count_kmer 1	mutated	564	24	8	0	596
NextPolish	-min_map_quality 52 -max_ins_fold_sgs 3 -max_clip_ratio_sgs 0.89 -trim_len_edge 1 -ext_len_edge 0 -indel_balance_factor_sgs 0.99 -min_count_ratio_skip 0.61 -max_len_kmer 32 -min_len_inter_kmer 3 -max_count_kmer 86	random	593	23	13	0	629
NextPolish	-min_map_quality 51 -max_ins_fold_sgs 7 -max_clip_ratio_sgs 0.01 -trim_len_edge 0 -ext_len_edge 4 -indel_balance_factor_sgs 0.39 -min_count_ratio_skip 0.3 -max_len_kmer 99 -min_len_inter_kmer 5 -max_count_kmer 1	mutated	564	24	8	0	596
NextPolish	-min_map_quality 14 -max_ins_fold_sgs 3 -max_clip_ratio_sgs 0.0 -trim_len_edge 20 -ext_len_edge 2 -indel_balance_factor_sgs 0.26 -min_count_ratio_skip 0.75 -max_len_kmer 35 -min_len_inter_kmer 9 -max_count_kmer 11	random	867	71	22	1	961
NextPolish	-min_map_quality 17 -max_ins_fold_sgs 10 -max_clip_ratio_sgs 0.12 -trim_len_edge 7 -ext_len_edge 3 -indel_balance_factor_sgs 0.57 -min_count_ratio_skip 0.71 -max_len_kmer 100 -min_len_inter_kmer 9 -max_count_kmer 66	random	857	59	21	0	937
NextPolish	-min_map_quality 51 -max_ins_fold_sgs 7 -max_clip_ratio_sgs 0.11 -trim_len_edge 0 -ext_len_edge 4 -indel_balance_factor_sgs 0.39 -min_count_ratio_skip 0.3 -max_len_kmer 99 -min_len_inter_kmer 5 -max_count_kmer 1	mutated	564	24	8	0	596
NextPolish	-min_map_quality 18 -max_ins_fold_sgs 10 -max_clip_ratio_sgs 0.08 -trim_len_edge 13 -ext_len_edge 17 -indel_balance_factor_sgs 0.23 -min_count_ratio_skip 0.77 -max_len_kmer 63 -min_len_inter_kmer 2 -max_count_kmer 14	random	880	74	20	3	977
NextPolish	-min_map_quality 51 -max_ins_fold_sgs 7 -max_clip_ratio_sgs 0.11 -trim_len_edge 0 -ext_len_edge 2 -indel_balance_factor_sgs 0.39 -min_count_ratio_skip 0.3 -max_len_kmer 99 -min_len_inter_kmer 5 -max_count_kmer 1	mutated	564	24	8	0	596
NextPolish	-min_map_quality 53 -max_ins_fold_sgs 1 -max_clip_ratio_sgs 0.0 -trim_len_edge 4 -ext_len_edge 0 -indel_balance_factor_sgs 0.28 -min_count_ratio_skip 0.95 -max_len_kmer 44 -min_len_inter_kmer 7 -max_count_kmer 95	random	939	88	23	3	1053
NextPolish	-min_map_quality 51 -max_ins_fold_sgs 9 -max_clip_ratio_sgs 0.11 -trim_len_edge 0 -ext_len_edge 3 -indel_balance_factor_sgs 0.39 -min_count_ratio_skip 0.3 -max_len_kmer 99 -min_len_inter_kmer 5 -max_count_kmer 1	mutated	564	24	8	0	596
NextPolish	-min_map_quality 50 -max_ins_fold_sgs 14 -max_clip_ratio_sgs 0.62 -trim_len_edge 15 -ext_len_edge 3 -indel_balance_factor_sgs 0.89 -min_count_ratio_skip 0.46 -max_len_kmer 41 -min_len_inter_kmer 2 -max_count_kmer 90	random	1009	126	33	2	1170
NextPolish	-min_map_quality 29 -max_ins_fold_sgs 9 -max_clip_ratio_sgs 0.2 -trim_len_edge 5 -ext_len_edge 0 -indel_balance_factor_sgs 0.79 -min_count_ratio_skip 0.64 -max_len_kmer 28 -min_len_inter_kmer 9 -max_count_kmer 100	random	676	37	16	0	729
NextPolish	-min_map_quality 32 -max_ins_fold_sgs 12 -max_clip_ratio_sgs 0.0 -trim_len_edge 23 -ext_len_edge 7 -indel_balance_factor_sgs 0.57 -min_count_ratio_skip 0.56 -max_len_kmer 41 -min_len_inter_kmer 6 -max_count_kmer 68	random	776	66	19	1	862
NextPolish	-min_map_quality 42 -max_ins_fold_sgs 15 -max_clip_ratio_sgs 0.01 -trim_len_edge 0 -ext_len_edge 1 -indel_balance_factor_sgs 0.68 -min_count_ratio_skip 0.78 -max_len_kmer 13 -min_len_inter_kmer 3 -max_count_kmer 100	random	862	62	16	0	940
NextPolish	-min_map_quality 36 -max_ins_fold_sgs 3 -max_clip_ratio_sgs 0.43 -trim_len_edge 3 -ext_len_edge 24 -indel_balance_factor_sgs 0.72 -min_count_ratio_skip 0.99 -max_len_kmer 52 -min_len_inter_kmer 4 -max_count_kmer 83	random	944	88	23	4	1059
NextPolish	-min_map_quality 21 -max_ins_fold_sgs 3 -max_clip_ratio_sgs 0.74 -trim_len_edge 1 -ext_len_edge 0 -indel_balance_factor_sgs 0.28 -min_count_ratio_skip 0.66 -max_len_kmer 29 -min_len_inter_kmer 7 -max_count_kmer 95	random	593	23	13	0	629
NextPolish	-min_map_quality 52 -max_ins_fold_sgs 7 -max_clip_ratio_sgs 0.11 -trim_len_edge 0 -ext_len_edge 3 -indel_balance_factor_sgs 0.39 -min_count_ratio_skip 0.3 -max_len_kmer 99 -min_len_inter_kmer 5 -max_count_kmer 1	mutated	564	24	8	0	596
NextPolish	-min_map_quality 56 -max_ins_fold_sgs 13 -max_clip_ratio_sgs 0.0 -trim_len_edge 27 -ext_len_edge 14 -indel_balance_factor_sgs 0.26 -min_count_ratio_skip 0.75 -max_len_kmer 42 -min_len_inter_kmer 4 -max_count_kmer 11	random	912	77	23	1	1013
NextPolish	-min_map_quality 52 -max_ins_fold_sgs 7 -max_clip_ratio_sgs 0.11 -trim_len_edge 0 -ext_len_edge 3 -indel_balance_factor_sgs 0.33 -min_count_ratio_skip 0.3 -max_len_kmer 99 -min_len_inter_kmer 5 -max_count_kmer 1	mutated	564	24	8	0	596
NextPolish	-min_map_quality 57 -max_ins_fold_sgs 8 -max_clip_ratio_sgs 0.36 -trim_len_edge 0 -ext_len_edge 21 -indel_balance_factor_sgs 0.35 -min_count_ratio_skip 0.78 -max_len_kmer 26 -min_len_inter_kmer 4 -max_count_kmer 24	random	862	62	16	0	940
NextPolish	-min_map_quality 51 -max_ins_fold_sgs 4 -max_clip_ratio_sgs 0.2 -trim_len_edge 16 -ext_len_edge 1 -indel_balance_factor_sgs 1.0 -min_count_ratio_skip 0.85 -max_len_kmer 85 -min_len_inter_kmer 3 -max_count_kmer 2	random	924	85	18	3	1030
NextPolish	-min_map_quality 52 -max_ins_fold_sgs 7 -max_clip_ratio_sgs 0.11 -trim_len_edge 0 -ext_len_edge 3 -indel_balance_factor_sgs 0.39 -min_count_ratio_skip 0.33 -max_len_kmer 99 -min_len_inter_kmer 5 -max_count_kmer 1	mutated	564	24	8	0	596
NextPolish	-min_map_quality 23 -max_ins_fold_sgs 14 -max_clip_ratio_sgs 0.23 -trim_len_edge 5 -ext_len_edge 9 -indel_balance_factor_sgs 0.95 -min_count_ratio_skip 0.93 -max_len_kmer 37 -min_len_inter_kmer 3 -max_count_kmer 4	random	941	86	22	3	1052
NextPolish	-min_map_quality 49 -max_ins_fold_sgs 4 -max_clip_ratio_sgs 0.02 -trim_len_edge 4 -ext_len_edge 7 -indel_balance_factor_sgs 0.69 -min_count_ratio_skip 0.9 -max_len_kmer 23 -min_len_inter_kmer 1 -max_count_kmer 25	random	939	86	23	3	1051
NextPolish	-min_map_quality 57 -max_ins_fold_sgs 9 -max_clip_ratio_sgs 0.11 -trim_len_edge 0 -ext_len_edge 3 -indel_balance_factor_sgs 0.39 -min_count_ratio_skip 0.33 -max_len_kmer 99 -min_len_inter_kmer 5 -max_count_kmer 1	mutated	564	24	8	0	596
NextPolish	-min_map_quality 4 -max_ins_fold_sgs 7 -max_clip_ratio_sgs 0.92 -trim_len_edge 3 -ext_len_edge 5 -indel_balance_factor_sgs 0.19 -min_count_ratio_skip 0.82 -max_len_kmer 28 -min_len_inter_kmer 8 -max_count_kmer 8	random	919	73	23	0	1015
NextPolish	-min_map_quality 57 -max_ins_fold_sgs 9 -max_clip_ratio_sgs 0.11 -trim_len_edge 2 -ext_len_edge 3 -indel_balance_factor_sgs 0.39 -min_count_ratio_skip 0.33 -max_len_kmer 99 -min_len_inter_kmer 5 -max_count_kmer 4	mutated	602	25	11	0	638
NextPolish	-min_map_quality 23 -max_ins_fold_sgs 4 -max_clip_ratio_sgs 0.19 -trim_len_edge 2 -ext_len_edge 9 -indel_balance_factor_sgs 0.87 -min_count_ratio_skip 0.91 -max_len_kmer 48 -min_len_inter_kmer 3 -max_count_kmer 54	random	945	86	21	3	1055
NextPolish	-min_map_quality 57 -max_ins_fold_sgs 9 -max_clip_ratio_sgs 0.11 -trim_len_edge 0 -ext_len_edge 3 -indel_balance_factor_sgs 0.39 -min_count_ratio_skip 0.26 -max_len_kmer 99 -min_len_inter_kmer 5 -max_count_kmer 1	mutated	564	24	8	0	596
NextPolish	-min_map_quality 6 -max_ins_fold_sgs 2 -max_clip_ratio_sgs 0.27 -trim_len_edge 17 -ext_len_edge 7 -indel_balance_factor_sgs 0.18 -min_count_ratio_skip 0.59 -max_len_kmer 76 -min_len_inter_kmer 3 -max_count_kmer 58	random	744	57	14	1	816
NextPolish	-min_map_quality 57 -max_ins_fold_sgs 9 -max_clip_ratio_sgs 0.11 -trim_len_edge 0 -ext_len_edge 3 -indel_balance_factor_sgs 0.39 -min_count_ratio_skip 0.35 -max_len_kmer 100 -min_len_inter_kmer 5 -max_count_kmer 1	mutated	569	24	8	0	601
NextPolish	-min_map_quality 55 -max_ins_fold_sgs 8 -max_clip_ratio_sgs 0.45 -trim_len_edge 0 -ext_len_edge 1 -indel_balance_factor_sgs 0.28 -min_count_ratio_skip 0.91 -max_len_kmer 72 -min_len_inter_kmer 10 -max_count_kmer 9	random	957	88	22	3	1070
NextPolish	-min_map_quality 17 -max_ins_fold_sgs 1 -max_clip_ratio_sgs 0.0 -trim_len_edge 0 -ext_len_edge 3 -indel_balance_factor_sgs 0.68 -min_count_ratio_skip 0.78 -max_len_kmer 39 -min_len_inter_kmer 3 -max_count_kmer 67	random	862	62	16	0	940
NextPolish	-min_map_quality 57 -max_ins_fold_sgs 9 -max_clip_ratio_sgs 0.11 -trim_len_edge 0 -ext_len_edge 3 -indel_balance_factor_sgs 0.39 -min_count_ratio_skip 0.36 -max_len_kmer 99 -min_len_inter_kmer 5 -max_count_kmer 1	mutated	569	24	8	0	601
NextPolish	-min_map_quality 40 -max_ins_fold_sgs 5 -max_clip_ratio_sgs 0.01 -trim_len_edge 4 -ext_len_edge 0 -indel_balance_factor_sgs 0.58 -min_count_ratio_skip 0.55 -max_len_kmer 62 -min_len_inter_kmer 8 -max_count_kmer 62	random	647	33	16	0	696
NextPolish	-min_map_quality 57 -max_ins_fold_sgs 7 -max_clip_ratio_sgs 0.11 -trim_len_edge 0 -ext_len_edge 3 -indel_balance_factor_sgs 0.39 -min_count_ratio_skip 0.26 -max_len_kmer 99 -min_len_inter_kmer 5 -max_count_kmer 1	mutated	564	24	8	0	596
NextPolish	-min_map_quality 15 -max_ins_fold_sgs 15 -max_clip_ratio_sgs 0.04 -trim_len_edge 10 -ext_len_edge 13 -indel_balance_factor_sgs 0.82 -min_count_ratio_skip 0.96 -max_len_kmer 11 -min_len_inter_kmer 4 -max_count_kmer 47	random	917	80	19	3	1019
NextPolish	-min_map_quality 20 -max_ins_fold_sgs 9 -max_clip_ratio_sgs 0.0 -trim_len_edge 0 -ext_len_edge 0 -indel_balance_factor_sgs 0.07 -min_count_ratio_skip 0.91 -max_len_kmer 74 -min_len_inter_kmer 6 -max_count_kmer 5	random	957	88	22	3	1070
NextPolish	-min_map_quality 57 -max_ins_fold_sgs 9 -max_clip_ratio_sgs 0.11 -trim_len_edge 0 -ext_len_edge 3 -indel_balance_factor_sgs 0.39 -min_count_ratio_skip 0.35 -max_len_kmer 99 -min_len_inter_kmer 5 -max_count_kmer 1	mutated	569	24	8	0	601
NextPolish	-min_map_quality 17 -max_ins_fold_sgs 15 -max_clip_ratio_sgs 0.36 -trim_len_edge 7 -ext_len_edge 0 -indel_balance_factor_sgs 0.36 -min_count_ratio_skip 0.69 -max_len_kmer 78 -min_len_inter_kmer 5 -max_count_kmer 99	random	857	59	21	0	937
NextPolish	-min_map_quality 11 -max_ins_fold_sgs 4 -max_clip_ratio_sgs 0.15 -trim_len_edge 0 -ext_len_edge 4 -indel_balance_factor_sgs 0.31 -min_count_ratio_skip 0.73 -max_len_kmer 40 -min_len_inter_kmer 5 -max_count_kmer 49	random	778	47	13	0	838
NextPolish	-min_map_quality 57 -max_ins_fold_sgs 7 -max_clip_ratio_sgs 0.11 -trim_len_edge 0 -ext_len_edge 3 -indel_balance_factor_sgs 0.39 -min_count_ratio_skip 0.33 -max_len_kmer 99 -min_len_inter_kmer 7 -max_count_kmer 1	mutated	564	24	8	0	596
NextPolish	-min_map_quality 42 -max_ins_fold_sgs 7 -max_clip_ratio_sgs 0.13 -trim_len_edge 10 -ext_len_edge 1 -indel_balance_factor_sgs 0.97 -min_count_ratio_skip 0.57 -max_len_kmer 64 -min_len_inter_kmer 7 -max_count_kmer 82	random	694	36	15	0	745
NextPolish	-min_map_quality 60 -max_ins_fold_sgs 7 -max_clip_ratio_sgs 0.11 -trim_len_edge 0 -ext_len_edge 3 -indel_balance_factor_sgs 0.39 -min_count_ratio_skip 0.33 -max_len_kmer 99 -min_len_inter_kmer 7 -max_count_kmer 1	mutated	564	24	8	0	596
NextPolish	-min_map_quality 15 -max_ins_fold_sgs 8 -max_clip_ratio_sgs 0.25 -trim_len_edge 20 -ext_len_edge 6 -indel_balance_factor_sgs 0.82 -min_count_ratio_skip 0.99 -max_len_kmer 29 -min_len_inter_kmer 10 -max_count_kmer 42	random	900	79	22	4	1005
NextPolish	-min_map_quality 56 -max_ins_fold_sgs 5 -max_clip_ratio_sgs 0.11 -trim_len_edge 0 -ext_len_edge 3 -indel_balance_factor_sgs 0.39 -min_count_ratio_skip 0.33 -max_len_kmer 99 -min_len_inter_kmer 7 -max_count_kmer 1	mutated	564	24	8	0	596
NextPolish	-min_map_quality 56 -max_ins_fold_sgs 2 -max_clip_ratio_sgs 0.95 -trim_len_edge 14 -ext_len_edge 7 -indel_balance_factor_sgs 0.34 -min_count_ratio_skip 0.51 -max_len_kmer 40 -min_len_inter_kmer 4 -max_count_kmer 56	random	714	55	16	0	785
NextPolish	-min_map_quality 56 -max_ins_fold_sgs 3 -max_clip_ratio_sgs 0.11 -trim_len_edge 0 -ext_len_edge 3 -indel_balance_factor_sgs 0.39 -min_count_ratio_skip 0.33 -max_len_kmer 99 -min_len_inter_kmer 7 -max_count_kmer 1	mutated	564	24	8	0	596
NextPolish	-min_map_quality 6 -max_ins_fold_sgs 5 -max_clip_ratio_sgs 0.11 -trim_len_edge 0 -ext_len_edge 0 -indel_balance_factor_sgs 0.49 -min_count_ratio_skip 0.36 -max_len_kmer 14 -min_len_inter_kmer 8 -max_count_kmer 41	random	569	24	8	0	601
NextPolish	-min_map_quality 32 -max_ins_fold_sgs 13 -max_clip_ratio_sgs 0.07 -trim_len_edge 5 -ext_len_edge 0 -indel_balance_factor_sgs 0.11 -min_count_ratio_skip 0.78 -max_len_kmer 100 -min_len_inter_kmer 10 -max_count_kmer 53	random	911	67	23	0	1001
NextPolish	-min_map_quality 56 -max_ins_fold_sgs 3 -max_clip_ratio_sgs 0.11 -trim_len_edge 0 -ext_len_edge 3 -indel_balance_factor_sgs 0.42 -min_count_ratio_skip 0.33 -max_len_kmer 99 -min_len_inter_kmer 7 -max_count_kmer 1	mutated	564	24	8	0	596
NextPolish	-min_map_quality 13 -max_ins_fold_sgs 2 -max_clip_ratio_sgs 0.65 -trim_len_edge 0 -ext_len_edge 4 -indel_balance_factor_sgs 0.32 -min_count_ratio_skip 0.97 -max_len_kmer 66 -min_len_inter_kmer 1 -max_count_kmer 26	random	957	91	22	4	1074
NextPolish	-min_map_quality 56 -max_ins_fold_sgs 3 -max_clip_ratio_sgs 0.11 -trim_len_edge 0 -ext_len_edge 3 -indel_balance_factor_sgs 0.42 -min_count_ratio_skip 0.33 -max_len_kmer 99 -min_len_inter_kmer 6 -max_count_kmer 11	mutated	564	24	8	0	596
NextPolish	-min_map_quality 0 -max_ins_fold_sgs 3 -max_clip_ratio_sgs 0.26 -trim_len_edge 0 -ext_len_edge 15 -indel_balance_factor_sgs 0.78 -min_count_ratio_skip 0.86 -max_len_kmer 13 -min_len_inter_kmer 8 -max_count_kmer 11	random	940	84	20	3	1047
NextPolish	-min_map_quality 56 -max_ins_fold_sgs 3 -max_clip_ratio_sgs 0.11 -trim_len_edge 2 -ext_len_edge 3 -indel_balance_factor_sgs 0.42 -min_count_ratio_skip 0.33 -max_len_kmer 99 -min_len_inter_kmer 6 -max_count_kmer 11	mutated	602	25	11	0	638
NextPolish	-min_map_quality 38 -max_ins_fold_sgs 16 -max_clip_ratio_sgs 0.44 -trim_len_edge 26 -ext_len_edge 8 -indel_balance_factor_sgs 0.25 -min_count_ratio_skip 0.91 -max_len_kmer 17 -min_len_inter_kmer 2 -max_count_kmer 77	random	916	85	23	4	1028
NextPolish	-min_map_quality 6 -max_ins_fold_sgs 2 -max_clip_ratio_sgs 0.69 -trim_len_edge 3 -ext_len_edge 6 -indel_balance_factor_sgs 0.28 -min_count_ratio_skip 0.9 -max_len_kmer 59 -min_len_inter_kmer 5 -max_count_kmer 33	random	944	86	23	3	1056
NextPolish	-min_map_quality 56 -max_ins_fold_sgs 3 -max_clip_ratio_sgs 0.11 -trim_len_edge 0 -ext_len_edge 3 -indel_balance_factor_sgs 0.42 -min_count_ratio_skip 0.33 -max_len_kmer 99 -min_len_inter_kmer 4 -max_count_kmer 11	mutated	564	24	8	0	596
NextPolish	-min_map_quality 48 -max_ins_fold_sgs 3 -max_clip_ratio_sgs 0.02 -trim_len_edge 0 -ext_len_edge 4 -indel_balance_factor_sgs 0.84 -min_count_ratio_skip 0.45 -max_len_kmer 97 -min_len_inter_kmer 6 -max_count_kmer 45	random	567	24	8	0	599
NextPolish	-min_map_quality 54 -max_ins_fold_sgs 3 -max_clip_ratio_sgs 0.11 -trim_len_edge 0 -ext_len_edge 3 -indel_balance_factor_sgs 0.41 -min_count_ratio_skip 0.33 -max_len_kmer 99 -min_len_inter_kmer 4 -max_count_kmer 13	mutated	564	24	8	0	596
NextPolish	-min_map_quality 16 -max_ins_fold_sgs 1 -max_clip_ratio_sgs 0.82 -trim_len_edge 5 -ext_len_edge 23 -indel_balance_factor_sgs 0.65 -min_count_ratio_skip 0.93 -max_len_kmer 68 -min_len_inter_kmer 8 -max_count_kmer 10	random	941	86	22	3	1052
NextPolish	-min_map_quality 54 -max_ins_fold_sgs 3 -max_clip_ratio_sgs 0.11 -trim_len_edge 0 -ext_len_edge 3 -indel_balance_factor_sgs 0.41 -min_count_ratio_skip 0.41 -max_len_kmer 97 -min_len_inter_kmer 4 -max_count_kmer 11	mutated	568	24	8	0	600
NextPolish	-min_map_quality 1 -max_ins_fold_sgs 4 -max_clip_ratio_sgs 0.3 -trim_len_edge 2 -ext_len_edge 5 -indel_balance_factor_sgs 0.39 -min_count_ratio_skip 0.59 -max_len_kmer 16 -min_len_inter_kmer 6 -max_count_kmer 89	random	601	25	13	0	639
NextPolish	-min_map_quality 54 -max_ins_fold_sgs 3 -max_clip_ratio_sgs 0.11 -trim_len_edge 2 -ext_len_edge 3 -indel_balance_factor_sgs 0.41 -min_count_ratio_skip 0.33 -max_len_kmer 99 -min_len_inter_kmer 4 -max_count_kmer 13	mutated	602	25	11	0	638
NextPolish	-min_map_quality 24 -max_ins_fold_sgs 7 -max_clip_ratio_sgs 0.95 -trim_len_edge 26 -ext_len_edge 26 -indel_balance_factor_sgs 0.24 -min_count_ratio_skip 0.99 -max_len_kmer 47 -min_len_inter_kmer 1 -max_count_kmer 26	random	916	85	23	4	1028
NextPolish	-min_map_quality 54 -max_ins_fold_sgs 3 -max_clip_ratio_sgs 0.11 -trim_len_edge 0 -ext_len_edge 3 -indel_balance_factor_sgs 0.41 -min_count_ratio_skip 0.33 -max_len_kmer 99 -min_len_inter_kmer 4 -max_count_kmer 3	mutated	564	24	8	0	596
NextPolish	-min_map_quality 44 -max_ins_fold_sgs 3 -max_clip_ratio_sgs 0.02 -trim_len_edge 3 -ext_len_edge 11 -indel_balance_factor_sgs 0.39 -min_count_ratio_skip 0.64 -max_len_kmer 63 -min_len_inter_kmer 9 -max_count_kmer 47	random	640	30	16	0	686
NextPolish	-min_map_quality 48 -max_ins_fold_sgs 2 -max_clip_ratio_sgs 0.58 -trim_len_edge 0 -ext_len_edge 13 -indel_balance_factor_sgs 0.35 -min_count_ratio_skip 0.62 -max_len_kmer 43 -min_len_inter_kmer 3 -max_count_kmer 59	random	575	25	11	0	611
NextPolish	-min_map_quality 10 -max_ins_fold_sgs 6 -max_clip_ratio_sgs 0.5 -trim_len_edge 16 -ext_len_edge 1 -indel_balance_factor_sgs 0.67 -min_count_ratio_skip 0.44 -max_len_kmer 76 -min_len_inter_kmer 3 -max_count_kmer 92	random	1049	140	37	4	1230
NextPolish	-min_map_quality 52 -max_ins_fold_sgs 1 -max_clip_ratio_sgs 0.08 -trim_len_edge 3 -ext_len_edge 22 -indel_balance_factor_sgs 0.77 -min_count_ratio_skip 0.94 -max_len_kmer 56 -min_len_inter_kmer 2 -max_count_kmer 69	random	944	88	23	3	1058
NextPolish	-min_map_quality 37 -max_ins_fold_sgs 12 -max_clip_ratio_sgs 0.0 -trim_len_edge 9 -ext_len_edge 0 -indel_balance_factor_sgs 0.1 -min_count_ratio_skip 0.94 -max_len_kmer 81 -min_len_inter_kmer 3 -max_count_kmer 62	random	920	79	18	3	1020
NextPolish	-min_map_quality 47 -max_ins_fold_sgs 10 -max_clip_ratio_sgs 0.35 -trim_len_edge 0 -ext_len_edge 11 -indel_balance_factor_sgs 0.17 -min_count_ratio_skip 0.98 -max_len_kmer 45 -min_len_inter_kmer 2 -max_count_kmer 77	random	957	91	22	4	1074
NextPolish	-min_map_quality 54 -max_ins_fold_sgs 3 -max_clip_ratio_sgs 0.11 -trim_len_edge 0 -ext_len_edge 3 -indel_balance_factor_sgs 0.41 -min_count_ratio_skip 0.33 -max_len_kmer 106 -min_len_inter_kmer 4 -max_count_kmer 3	mutated	564	24	8	0	596
NextPolish	-min_map_quality 31 -max_ins_fold_sgs 2 -max_clip_ratio_sgs 0.06 -trim_len_edge 9 -ext_len_edge 0 -indel_balance_factor_sgs 0.84 -min_count_ratio_skip 0.47 -max_len_kmer 51 -min_len_inter_kmer 2 -max_count_kmer 74	random	794	55	19	0	868
NextPolish	-min_map_quality 54 -max_ins_fold_sgs 3 -max_clip_ratio_sgs 0.07 -trim_len_edge 0 -ext_len_edge 3 -indel_balance_factor_sgs 0.41 -min_count_ratio_skip 0.33 -max_len_kmer 106 -min_len_inter_kmer 4 -max_count_kmer 3	mutated	564	24	8	0	596
NextPolish	-min_map_quality 4 -max_ins_fold_sgs 5 -max_clip_ratio_sgs 0.92 -trim_len_edge 17 -ext_len_edge 1 -indel_balance_factor_sgs 0.16 -min_count_ratio_skip 0.59 -max_len_kmer 18 -min_len_inter_kmer 4 -max_count_kmer 77	random	744	57	14	1	816
NextPolish	-min_map_quality 54 -max_ins_fold_sgs 3 -max_clip_ratio_sgs 0.07 -trim_len_edge 0 -ext_len_edge 3 -indel_balance_factor_sgs 0.41 -min_count_ratio_skip 0.33 -max_len_kmer 106 -min_len_inter_kmer 3 -max_count_kmer 3	mutated	564	24	8	0	596
NextPolish	-min_map_quality 22 -max_ins_fold_sgs 1 -max_clip_ratio_sgs 0.03 -trim_len_edge 7 -ext_len_edge 3 -indel_balance_factor_sgs 0.45 -min_count_ratio_skip 0.6 -max_len_kmer 72 -min_len_inter_kmer 9 -max_count_kmer 9	random	677	36	16	0	729
NextPolish	-min_map_quality 54 -max_ins_fold_sgs 3 -max_clip_ratio_sgs 0.07 -trim_len_edge 1 -ext_len_edge 3 -indel_balance_factor_sgs 0.41 -min_count_ratio_skip 0.33 -max_len_kmer 106 -min_len_inter_kmer 3 -max_count_kmer 3	mutated	586	23	9	0	618
NextPolish	-min_map_quality 24 -max_ins_fold_sgs 2 -max_clip_ratio_sgs 0.04 -trim_len_edge 0 -ext_len_edge 0 -indel_balance_factor_sgs 0.67 -min_count_ratio_skip 0.64 -max_len_kmer 25 -min_len_inter_kmer 2 -max_count_kmer 24	random	575	25	11	0	611
NextPolish	-min_map_quality 54 -max_ins_fold_sgs 3 -max_clip_ratio_sgs 0.07 -trim_len_edge 0 -ext_len_edge 3 -indel_balance_factor_sgs 0.41 -min_count_ratio_skip 0.33 -max_len_kmer 106 -min_len_inter_kmer 1 -max_count_kmer 3	mutated	564	24	8	0	596
NextPolish	-min_map_quality 11 -max_ins_fold_sgs 14 -max_clip_ratio_sgs 0.0 -trim_len_edge 1 -ext_len_edge 0 -indel_balance_factor_sgs 0.59 -min_count_ratio_skip 0.46 -max_len_kmer 23 -min_len_inter_kmer 10 -max_count_kmer 73	random	585	23	10	0	618
NextPolish	-min_map_quality 54 -max_ins_fold_sgs 3 -max_clip_ratio_sgs 0.02 -trim_len_edge 0 -ext_len_edge 3 -indel_balance_factor_sgs 0.41 -min_count_ratio_skip 0.33 -max_len_kmer 106 -min_len_inter_kmer 3 -max_count_kmer 3	mutated	564	24	8	0	596
NextPolish	-min_map_quality 19 -max_ins_fold_sgs 16 -max_clip_ratio_sgs 0.0 -trim_len_edge 3 -ext_len_edge 0 -indel_balance_factor_sgs 0.21 -min_count_ratio_skip 0.42 -max_len_kmer 10 -min_len_inter_kmer 9 -max_count_kmer 36	random	633	29	12	0	674
NextPolish	-min_map_quality 54 -max_ins_fold_sgs 3 -max_clip_ratio_sgs 0.02 -trim_len_edge 0 -ext_len_edge 3 -indel_balance_factor_sgs 0.41 -min_count_ratio_skip 0.32 -max_len_kmer 106 -min_len_inter_kmer 3 -max_count_kmer 3	mutated	564	24	8	0	596
NextPolish	-min_map_quality 35 -max_ins_fold_sgs 3 -max_clip_ratio_sgs 0.25 -trim_len_edge 25 -ext_len_edge 25 -indel_balance_factor_sgs 0.38 -min_count_ratio_skip 0.85 -max_len_kmer 11 -min_len_inter_kmer 7 -max_count_kmer 10	random	902	82	21	4	1009
NextPolish	-min_map_quality 54 -max_ins_fold_sgs 3 -max_clip_ratio_sgs 0.02 -trim_len_edge 0 -ext_len_edge 3 -indel_balance_factor_sgs 0.48 -min_count_ratio_skip 0.32 -max_len_kmer 106 -min_len_inter_kmer 3 -max_count_kmer 3	mutated	564	24	8	0	596
NextPolish	-min_map_quality 43 -max_ins_fold_sgs 12 -max_clip_ratio_sgs 0.15 -trim_len_edge 0 -ext_len_edge 1 -indel_balance_factor_sgs 0.84 -min_count_ratio_skip 0.49 -max_len_kmer 85 -min_len_inter_kmer 2 -max_count_kmer 7	random	567	24	8	0	599
NextPolish	-min_map_quality 41 -max_ins_fold_sgs 14 -max_clip_ratio_sgs 0.82 -trim_len_edge 0 -ext_len_edge 0 -indel_balance_factor_sgs 0.5 -min_count_ratio_skip 0.99 -max_len_kmer 30 -min_len_inter_kmer 3 -max_count_kmer 66	random	957	91	22	4	1074
NextPolish	-min_map_quality 38 -max_ins_fold_sgs 2 -max_clip_ratio_sgs 0.09 -trim_len_edge 1 -ext_len_edge 19 -indel_balance_factor_sgs 0.4 -min_count_ratio_skip 0.15 -max_len_kmer 57 -min_len_inter_kmer 2 -max_count_kmer 41	random	588	23	9	0	620
NextPolish	-min_map_quality 56 -max_ins_fold_sgs 3 -max_clip_ratio_sgs 0.02 -trim_len_edge 0 -ext_len_edge 3 -indel_balance_factor_sgs 0.48 -min_count_ratio_skip 0.32 -max_len_kmer 106 -min_len_inter_kmer 3 -max_count_kmer 1	mutated	564	24	8	0	596
NextPolish	-min_map_quality 57 -max_ins_fold_sgs 4 -max_clip_ratio_sgs 0.24 -trim_len_edge 9 -ext_len_edge 0 -indel_balance_factor_sgs 0.0 -min_count_ratio_skip 0.82 -max_len_kmer 30 -min_len_inter_kmer 8 -max_count_kmer 48	random	910	74	19	3	1006
NextPolish	-min_map_quality 56 -max_ins_fold_sgs 3 -max_clip_ratio_sgs 0.02 -trim_len_edge 1 -ext_len_edge 3 -indel_balance_factor_sgs 0.48 -min_count_ratio_skip 0.32 -max_len_kmer 106 -min_len_inter_kmer 3 -max_count_kmer 1	mutated	586	23	9	0	618
NextPolish	-min_map_quality 37 -max_ins_fold_sgs 15 -max_clip_ratio_sgs 0.01 -trim_len_edge 4 -ext_len_edge 16 -indel_balance_factor_sgs 0.65 -min_count_ratio_skip 0.89 -max_len_kmer 87 -min_len_inter_kmer 4 -max_count_kmer 74	random	939	86	23	3	1051
NextPolish	-min_map_quality 49 -max_ins_fold_sgs 3 -max_clip_ratio_sgs 0.02 -trim_len_edge 0 -ext_len_edge 3 -indel_balance_factor_sgs 0.57 -min_count_ratio_skip 0.32 -max_len_kmer 106 -min_len_inter_kmer 5 -max_count_kmer 9	mutated	564	24	8	0	596
NextPolish	-min_map_quality 5 -max_ins_fold_sgs 9 -max_clip_ratio_sgs 0.33 -trim_len_edge 11 -ext_len_edge 7 -indel_balance_factor_sgs 0.74 -min_count_ratio_skip 0.54 -max_len_kmer 75 -min_len_inter_kmer 5 -max_count_kmer 40	random	696	35	15	0	746
NextPolish	-min_map_quality 0 -max_ins_fold_sgs 9 -max_clip_ratio_sgs 0.72 -trim_len_edge 26 -ext_len_edge 0 -indel_balance_factor_sgs 0.84 -min_count_ratio_skip 0.89 -max_len_kmer 46 -min_len_inter_kmer 7 -max_count_kmer 71	random	916	85	23	4	1028
NextPolish	-min_map_quality 51 -max_ins_fold_sgs 3 -max_clip_ratio_sgs 0.02 -trim_len_edge 0 -ext_len_edge 3 -indel_balance_factor_sgs 0.57 -min_count_ratio_skip 0.32 -max_len_kmer 106 -min_len_inter_kmer 5 -max_count_kmer 9	mutated	564	24	8	0	596
NextPolish	-min_map_quality 17 -max_ins_fold_sgs 15 -max_clip_ratio_sgs 0.01 -trim_len_edge 1 -ext_len_edge 2 -indel_balance_factor_sgs 0.77 -min_count_ratio_skip 0.73 -max_len_kmer 90 -min_len_inter_kmer 10 -max_count_kmer 22	random	792	52	14	0	858
NextPolish	-min_map_quality 30 -max_ins_fold_sgs 5 -max_clip_ratio_sgs 0.0 -trim_len_edge 0 -ext_len_edge 20 -indel_balance_factor_sgs 0.55 -min_count_ratio_skip 0.44 -max_len_kmer 71 -min_len_inter_kmer 6 -max_count_kmer 25	random	567	24	8	0	599
NextPolish	-min_map_quality 51 -max_ins_fold_sgs 3 -max_clip_ratio_sgs 0.02 -trim_len_edge 0 -ext_len_edge 3 -indel_balance_factor_sgs 0.57 -min_count_ratio_skip 0.3 -max_len_kmer 106 -min_len_inter_kmer 5 -max_count_kmer 9	mutated	564	24	8	0	596
NextPolish	-min_map_quality 36 -max_ins_fold_sgs 1 -max_clip_ratio_sgs 0.04 -trim_len_edge 4 -ext_len_edge 0 -indel_balance_factor_sgs 0.09 -min_count_ratio_skip 0.99 -max_len_kmer 23 -min_len_inter_kmer 4 -max_count_kmer 4	random	939	88	23	4	1054
NextPolish	-min_map_quality 26 -max_ins_fold_sgs 6 -max_clip_ratio_sgs 0.01 -trim_len_edge 20 -ext_len_edge 8 -indel_balance_factor_sgs 0.28 -min_count_ratio_skip 0.44 -max_len_kmer 40 -min_len_inter_kmer 5 -max_count_kmer 92	random	1213	182	53	13	1461
NextPolish	-min_map_quality 51 -max_ins_fold_sgs 3 -max_clip_ratio_sgs 0.02 -trim_len_edge 0 -ext_len_edge 3 -indel_balance_factor_sgs 0.61 -min_count_ratio_skip 0.3 -max_len_kmer 115 -min_len_inter_kmer 5 -max_count_kmer 9	mutated	564	24	8	0	596
NextPolish	-min_map_quality 33 -max_ins_fold_sgs 2 -max_clip_ratio_sgs 0.0 -trim_len_edge 10 -ext_len_edge 0 -indel_balance_factor_sgs 0.11 -min_count_ratio_skip 0.63 -max_len_kmer 20 -min_len_inter_kmer 3 -max_count_kmer 11	random	702	36	15	0	753
NextPolish	-min_map_quality 51 -max_ins_fold_sgs 3 -max_clip_ratio_sgs 0.02 -trim_len_edge 0 -ext_len_edge 3 -indel_balance_factor_sgs 0.61 -min_count_ratio_skip 0.25 -max_len_kmer 115 -min_len_inter_kmer 5 -max_count_kmer 9	mutated	566	24	8	0	598
NextPolish	-min_map_quality 56 -max_ins_fold_sgs 15 -max_clip_ratio_sgs 0.12 -trim_len_edge 0 -ext_len_edge 16 -indel_balance_factor_sgs 0.15 -min_count_ratio_skip 0.44 -max_len_kmer 64 -min_len_inter_kmer 9 -max_count_kmer 57	random	567	24	8	0	599
NextPolish	-min_map_quality 51 -max_ins_fold_sgs 3 -max_clip_ratio_sgs 0.09 -trim_len_edge 0 -ext_len_edge 3 -indel_balance_factor_sgs 0.61 -min_count_ratio_skip 0.3 -max_len_kmer 115 -min_len_inter_kmer 5 -max_count_kmer 9	mutated	564	24	8	0	596
NextPolish	-min_map_quality 55 -max_ins_fold_sgs 11 -max_clip_ratio_sgs 0.0 -trim_len_edge 11 -ext_len_edge 3 -indel_balance_factor_sgs 0.82 -min_count_ratio_skip 0.75 -max_len_kmer 32 -min_len_inter_kmer 1 -max_count_kmer 83	random	851	59	19	0	929
NextPolish	-min_map_quality 51 -max_ins_fold_sgs 3 -max_clip_ratio_sgs 0.09 -trim_len_edge 0 -ext_len_edge 3 -indel_balance_factor_sgs 0.61 -min_count_ratio_skip 0.25 -max_len_kmer 119 -min_len_inter_kmer 5 -max_count_kmer 9	mutated	566	24	8	0	598
NextPolish	-min_map_quality 48 -max_ins_fold_sgs 1 -max_clip_ratio_sgs 0.2 -trim_len_edge 7 -ext_len_edge 4 -indel_balance_factor_sgs 0.52 -min_count_ratio_skip 0.61 -max_len_kmer 100 -min_len_inter_kmer 2 -max_count_kmer 76	random	685	37	16	0	738
NextPolish	-min_map_quality 60 -max_ins_fold_sgs 9 -max_clip_ratio_sgs 0.56 -trim_len_edge 3 -ext_len_edge 0 -indel_balance_factor_sgs 0.19 -min_count_ratio_skip 0.89 -max_len_kmer 93 -min_len_inter_kmer 7 -max_count_kmer 56	random	944	86	23	3	1056
NextPolish	-min_map_quality 3 -max_ins_fold_sgs 5 -max_clip_ratio_sgs 0.01 -trim_len_edge 0 -ext_len_edge 3 -indel_balance_factor_sgs 0.98 -min_count_ratio_skip 0.93 -max_len_kmer 92 -min_len_inter_kmer 3 -max_count_kmer 91	random	957	91	22	3	1073
NextPolish	-min_map_quality 51 -max_ins_fold_sgs 3 -max_clip_ratio_sgs 0.09 -trim_len_edge 0 -ext_len_edge 3 -indel_balance_factor_sgs 0.56 -min_count_ratio_skip 0.3 -max_len_kmer 115 -min_len_inter_kmer 5 -max_count_kmer 9	mutated	564	24	8	0	596
NextPolish	-min_map_quality 36 -max_ins_fold_sgs 5 -max_clip_ratio_sgs 0.57 -trim_len_edge 13 -ext_len_edge 1 -indel_balance_factor_sgs 0.56 -min_count_ratio_skip 0.57 -max_len_kmer 90 -min_len_inter_kmer 5 -max_count_kmer 75	random	706	45	16	0	767
NextPolish	-min_map_quality 51 -max_ins_fold_sgs 3 -max_clip_ratio_sgs 0.09 -trim_len_edge 0 -ext_len_edge 3 -indel_balance_factor_sgs 0.56 -min_count_ratio_skip 0.3 -max_len_kmer 115 -min_len_inter_kmer 7 -max_count_kmer 9	mutated	564	24	8	0	596
NextPolish	-min_map_quality 9 -max_ins_fold_sgs 5 -max_clip_ratio_sgs 0.48 -trim_len_edge 3 -ext_len_edge 9 -indel_balance_factor_sgs 0.62 -min_count_ratio_skip 0.52 -max_len_kmer 31 -min_len_inter_kmer 2 -max_count_kmer 37	random	631	29	16	0	676
NextPolish	-min_map_quality 59 -max_ins_fold_sgs 6 -max_clip_ratio_sgs 0.02 -trim_len_edge 1 -ext_len_edge 1 -indel_balance_factor_sgs 0.0 -min_count_ratio_skip 0.7 -max_len_kmer 88 -min_len_inter_kmer 7 -max_count_kmer 43	random	791	51	14	0	856
NextPolish	-min_map_quality 51 -max_ins_fold_sgs 3 -max_clip_ratio_sgs 0.09 -trim_len_edge 0 -ext_len_edge 3 -indel_balance_factor_sgs 0.61 -min_count_ratio_skip 0.3 -max_len_kmer 115 -min_len_inter_kmer 7 -max_count_kmer 9	mutated	564	24	8	0	596
NextPolish	-min_map_quality 39 -max_ins_fold_sgs 15 -max_clip_ratio_sgs 0.39 -trim_len_edge 0 -ext_len_edge 0 -indel_balance_factor_sgs 0.2 -min_count_ratio_skip 0.67 -max_len_kmer 70 -min_len_inter_kmer 3 -max_count_kmer 16	random	777	46	13	0	836
NextPolish	-min_map_quality 51 -max_ins_fold_sgs 3 -max_clip_ratio_sgs 0.09 -trim_len_edge 0 -ext_len_edge 3 -indel_balance_factor_sgs 0.61 -min_count_ratio_skip 0.3 -max_len_kmer 108 -min_len_inter_kmer 7 -max_count_kmer 2	mutated	564	24	8	0	596
NextPolish	-min_map_quality 29 -max_ins_fold_sgs 4 -max_clip_ratio_sgs 0.22 -trim_len_edge 5 -ext_len_edge 5 -indel_balance_factor_sgs 0.18 -min_count_ratio_skip 0.34 -max_len_kmer 41 -min_len_inter_kmer 8 -max_count_kmer 64	random	683	39	16	0	738
NextPolish	-min_map_quality 51 -max_ins_fold_sgs 3 -max_clip_ratio_sgs 0.09 -trim_len_edge 2 -ext_len_edge 3 -indel_balance_factor_sgs 0.61 -min_count_ratio_skip 0.3 -max_len_kmer 112 -min_len_inter_kmer 7 -max_count_kmer 2	mutated	602	25	11	0	638
NextPolish	-min_map_quality 43 -max_ins_fold_sgs 2 -max_clip_ratio_sgs 0.11 -trim_len_edge 17 -ext_len_edge 6 -indel_balance_factor_sgs 0.19 -min_count_ratio_skip 0.96 -max_len_kmer 15 -min_len_inter_kmer 2 -max_count_kmer 39	random	923	86	18	5	1032
NextPolish	-min_map_quality 56 -max_ins_fold_sgs 3 -max_clip_ratio_sgs 0.09 -trim_len_edge 0 -ext_len_edge 3 -indel_balance_factor_sgs 0.61 -min_count_ratio_skip 0.26 -max_len_kmer 108 -min_len_inter_kmer 7 -max_count_kmer 2	mutated	564	24	8	0	596
NextPolish	-min_map_quality 53 -max_ins_fold_sgs 3 -max_clip_ratio_sgs 0.7 -trim_len_edge 26 -ext_len_edge 1 -indel_balance_factor_sgs 0.41 -min_count_ratio_skip 0.74 -max_len_kmer 72 -min_len_inter_kmer 5 -max_count_kmer 64	random	900	80	23	1	1004
NextPolish	-min_map_quality 12 -max_ins_fold_sgs 11 -max_clip_ratio_sgs 0.09 -trim_len_edge 8 -ext_len_edge 0 -indel_balance_factor_sgs 0.35 -min_count_ratio_skip 0.7 -max_len_kmer 14 -min_len_inter_kmer 8 -max_count_kmer 88	random	851	59	17	0	927
NextPolish	-min_map_quality 56 -max_ins_fold_sgs 3 -max_clip_ratio_sgs 0.09 -trim_len_edge 0 -ext_len_edge 3 -indel_balance_factor_sgs 0.61 -min_count_ratio_skip 0.26 -max_len_kmer 108 -min_len_inter_kmer 7 -max_count_kmer 1	mutated	564	24	8	0	596
NextPolish	-min_map_quality 18 -max_ins_fold_sgs 4 -max_clip_ratio_sgs 0.89 -trim_len_edge 0 -ext_len_edge 0 -indel_balance_factor_sgs 0.78 -min_count_ratio_skip 0.83 -max_len_kmer 82 -min_len_inter_kmer 5 -max_count_kmer 58	random	909	72	17	0	998
NextPolish	-min_map_quality 56 -max_ins_fold_sgs 3 -max_clip_ratio_sgs 0.09 -trim_len_edge 0 -ext_len_edge 3 -indel_balance_factor_sgs 0.62 -min_count_ratio_skip 0.33 -max_len_kmer 108 -min_len_inter_kmer 7 -max_count_kmer 1	mutated	564	24	8	0	596
NextPolish	-min_map_quality 25 -max_ins_fold_sgs 1 -max_clip_ratio_sgs 0.01 -trim_len_edge 25 -ext_len_edge 3 -indel_balance_factor_sgs 0.45 -min_count_ratio_skip 0.98 -max_len_kmer 23 -min_len_inter_kmer 8 -max_count_kmer 92	random	902	82	21	4	1009
NextPolish	-min_map_quality 47 -max_ins_fold_sgs 2 -max_clip_ratio_sgs 0.09 -trim_len_edge 0 -ext_len_edge 3 -indel_balance_factor_sgs 0.56 -min_count_ratio_skip 0.33 -max_len_kmer 108 -min_len_inter_kmer 7 -max_count_kmer 1	mutated	564	24	8	0	596
NextPolish	-min_map_quality 8 -max_ins_fold_sgs 11 -max_clip_ratio_sgs 0.02 -trim_len_edge 1 -ext_len_edge 7 -indel_balance_factor_sgs 0.26 -min_count_ratio_skip 0.97 -max_len_kmer 31 -min_len_inter_kmer 2 -max_count_kmer 100	random	946	89	21	4	1060
NextPolish	-min_map_quality 13 -max_ins_fold_sgs 12 -max_clip_ratio_sgs 0.13 -trim_len_edge 24 -ext_len_edge 16 -indel_balance_factor_sgs 0.81 -min_count_ratio_skip 0.71 -max_len_kmer 92 -min_len_inter_kmer 8 -max_count_kmer 63	random	890	79	22	0	991
NextPolish	-min_map_quality 15 -max_ins_fold_sgs 6 -max_clip_ratio_sgs 0.75 -trim_len_edge 2 -ext_len_edge 1 -indel_balance_factor_sgs 0.99 -min_count_ratio_skip 0.73 -max_len_kmer 95 -min_len_inter_kmer 3 -max_count_kmer 80	random	815	53	15	0	883
NextPolish	-min_map_quality 58 -max_ins_fold_sgs 2 -max_clip_ratio_sgs 0.65 -trim_len_edge 1 -ext_len_edge 2 -indel_balance_factor_sgs 0.95 -min_count_ratio_skip 0.75 -max_len_kmer 75 -min_len_inter_kmer 6 -max_count_kmer 47	random	792	52	14	0	858
NextPolish	-min_map_quality 47 -max_ins_fold_sgs 2 -max_clip_ratio_sgs 0.09 -trim_len_edge 2 -ext_len_edge 3 -indel_balance_factor_sgs 0.51 -min_count_ratio_skip 0.33 -max_len_kmer 108 -min_len_inter_kmer 7 -max_count_kmer 1	mutated	602	25	11	0	638
NextPolish	-min_map_quality 34 -max_ins_fold_sgs 15 -max_clip_ratio_sgs 0.35 -trim_len_edge 7 -ext_len_edge 15 -indel_balance_factor_sgs 0.45 -min_count_ratio_skip 0.11 -max_len_kmer 44 -min_len_inter_kmer 6 -max_count_kmer 73	random	750	49	18	0	817
NextPolish	-min_map_quality 47 -max_ins_fold_sgs 2 -max_clip_ratio_sgs 0.09 -trim_len_edge 0 -ext_len_edge 3 -indel_balance_factor_sgs 0.56 -min_count_ratio_skip 0.38 -max_len_kmer 108 -min_len_inter_kmer 7 -max_count_kmer 1	mutated	569	24	8	0	601
NextPolish	-min_map_quality 30 -max_ins_fold_sgs 6 -max_clip_ratio_sgs 0.0 -trim_len_edge 1 -ext_len_edge 0 -indel_balance_factor_sgs 0.23 -min_count_ratio_skip 0.45 -max_len_kmer 18 -min_len_inter_kmer 2 -max_count_kmer 24	random	585	23	10	0	618
NextPolish	-min_map_quality 47 -max_ins_fold_sgs 2 -max_clip_ratio_sgs 0.04 -trim_len_edge 1 -ext_len_edge 3 -indel_balance_factor_sgs 0.56 -min_count_ratio_skip 0.33 -max_len_kmer 108 -min_len_inter_kmer 7 -max_count_kmer 1	mutated	586	23	9	0	618
NextPolish	-min_map_quality 3 -max_ins_fold_sgs 9 -max_clip_ratio_sgs 0.34 -trim_len_edge 6 -ext_len_edge 0 -indel_balance_factor_sgs 0.07 -min_count_ratio_skip 0.88 -max_len_kmer 32 -min_len_inter_kmer 9 -max_count_kmer 37	random	938	85	22	3	1048
NextPolish	-min_map_quality 7 -max_ins_fold_sgs 15 -max_clip_ratio_sgs 0.61 -trim_len_edge 0 -ext_len_edge 3 -indel_balance_factor_sgs 0.78 -min_count_ratio_skip 0.56 -max_len_kmer 100 -min_len_inter_kmer 6 -max_count_kmer 63	random	563	23	10	0	596
NextPolish	-min_map_quality 47 -max_ins_fold_sgs 15 -max_clip_ratio_sgs 0.01 -trim_len_edge 10 -ext_len_edge 10 -indel_balance_factor_sgs 0.54 -min_count_ratio_skip 0.87 -max_len_kmer 92 -min_len_inter_kmer 2 -max_count_kmer 75	random	915	80	19	3	1017
NextPolish	-min_map_quality 36 -max_ins_fold_sgs 6 -max_clip_ratio_sgs 0.53 -trim_len_edge 0 -ext_len_edge 24 -indel_balance_factor_sgs 0.63 -min_count_ratio_skip 0.74 -max_len_kmer 61 -min_len_inter_kmer 5 -max_count_kmer 47	random	778	47	13	0	838
NextPolish	-min_map_quality 59 -max_ins_fold_sgs 4 -max_clip_ratio_sgs 0.27 -trim_len_edge 12 -ext_len_edge 13 -indel_balance_factor_sgs 0.27 -min_count_ratio_skip 0.39 -max_len_kmer 94 -min_len_inter_kmer 8 -max_count_kmer 31	random	889	88	26	0	1003
NextPolish	-min_map_quality 7 -max_ins_fold_sgs 17 -max_clip_ratio_sgs 0.61 -trim_len_edge 0 -ext_len_edge 3 -indel_balance_factor_sgs 0.78 -min_count_ratio_skip 0.56 -max_len_kmer 108 -min_len_inter_kmer 8 -max_count_kmer 73	mutated	563	23	10	0	596
NextPolish	-min_map_quality 30 -max_ins_fold_sgs 3 -max_clip_ratio_sgs 0.56 -trim_len_edge 0 -ext_len_edge 2 -indel_balance_factor_sgs 0.18 -min_count_ratio_skip 0.95 -max_len_kmer 75 -min_len_inter_kmer 10 -max_count_kmer 38	random	957	91	22	3	1073
NextPolish	-min_map_quality 46 -max_ins_fold_sgs 7 -max_clip_ratio_sgs 0.07 -trim_len_edge 17 -ext_len_edge 2 -indel_balance_factor_sgs 0.44 -min_count_ratio_skip 0.6 -max_len_kmer 44 -min_len_inter_kmer 8 -max_count_kmer 18	random	744	57	14	1	816
NextPolish	-min_map_quality 7 -max_ins_fold_sgs 17 -max_clip_ratio_sgs 0.61 -trim_len_edge 0 -ext_len_edge 3 -indel_balance_factor_sgs 0.87 -min_count_ratio_skip 0.56 -max_len_kmer 108 -min_len_inter_kmer 8 -max_count_kmer 73	mutated	563	23	10	0	596
NextPolish	-min_map_quality 34 -max_ins_fold_sgs 4 -max_clip_ratio_sgs 0.27 -trim_len_edge 0 -ext_len_edge 2 -indel_balance_factor_sgs 0.74 -min_count_ratio_skip 0.93 -max_len_kmer 34 -min_len_inter_kmer 1 -max_count_kmer 34	random	957	91	22	3	1073
NextPolish	-min_map_quality 57 -max_ins_fold_sgs 9 -max_clip_ratio_sgs 0.0 -trim_len_edge 25 -ext_len_edge 10 -indel_balance_factor_sgs 0.61 -min_count_ratio_skip 0.26 -max_len_kmer 58 -min_len_inter_kmer 9 -max_count_kmer 28	random	1453	306	89	29	1877
NextPolish	-min_map_quality 7 -max_ins_fold_sgs 18 -max_clip_ratio_sgs 0.54 -trim_len_edge 0 -ext_len_edge 3 -indel_balance_factor_sgs 0.87 -min_count_ratio_skip 0.56 -max_len_kmer 98 -min_len_inter_kmer 8 -max_count_kmer 73	mutated	563	23	10	0	596
NextPolish	-min_map_quality 49 -max_ins_fold_sgs 1 -max_clip_ratio_sgs 0.51 -trim_len_edge 2 -ext_len_edge 0 -indel_balance_factor_sgs 0.93 -min_count_ratio_skip 0.15 -max_len_kmer 52 -min_len_inter_kmer 4 -max_count_kmer 24	random	604	25	11	0	640
NextPolish	-min_map_quality 7 -max_ins_fold_sgs 18 -max_clip_ratio_sgs 0.54 -trim_len_edge 0 -ext_len_edge 3 -indel_balance_factor_sgs 0.87 -min_count_ratio_skip 0.65 -max_len_kmer 98 -min_len_inter_kmer 8 -max_count_kmer 73	mutated	575	25	11	0	611
NextPolish	-min_map_quality 19 -max_ins_fold_sgs 14 -max_clip_ratio_sgs 0.83 -trim_len_edge 4 -ext_len_edge 14 -indel_balance_factor_sgs 0.26 -min_count_ratio_skip 0.49 -max_len_kmer 94 -min_len_inter_kmer 8 -max_count_kmer 94	random	652	34	15	0	701
NextPolish	-min_map_quality 52 -max_ins_fold_sgs 15 -max_clip_ratio_sgs 0.0 -trim_len_edge 19 -ext_len_edge 8 -indel_balance_factor_sgs 0.03 -min_count_ratio_skip 0.47 -max_len_kmer 81 -min_len_inter_kmer 5 -max_count_kmer 50	random	1168	170	49	11	1398
NextPolish	-min_map_quality 7 -max_ins_fold_sgs 18 -max_clip_ratio_sgs 0.54 -trim_len_edge 0 -ext_len_edge 1 -indel_balance_factor_sgs 0.87 -min_count_ratio_skip 0.56 -max_len_kmer 98 -min_len_inter_kmer 8 -max_count_kmer 73	mutated	563	23	10	0	596
NextPolish	-min_map_quality 5 -max_ins_fold_sgs 16 -max_clip_ratio_sgs 0.48 -trim_len_edge 4 -ext_len_edge 5 -indel_balance_factor_sgs 0.45 -min_count_ratio_skip 0.5 -max_len_kmer 36 -min_len_inter_kmer 5 -max_count_kmer 2	random	652	34	15	0	701
NextPolish	-min_map_quality 7 -max_ins_fold_sgs 19 -max_clip_ratio_sgs 0.63 -trim_len_edge 0 -ext_len_edge 1 -indel_balance_factor_sgs 0.87 -min_count_ratio_skip 0.56 -max_len_kmer 90 -min_len_inter_kmer 8 -max_count_kmer 73	mutated	563	23	10	0	596
NextPolish	-min_map_quality 18 -max_ins_fold_sgs 3 -max_clip_ratio_sgs 0.73 -trim_len_edge 0 -ext_len_edge 4 -indel_balance_factor_sgs 0.66 -min_count_ratio_skip 0.31 -max_len_kmer 17 -min_len_inter_kmer 4 -max_count_kmer 93	random	564	24	8	0	596
NextPolish	-min_map_quality 18 -max_ins_fold_sgs 3 -max_clip_ratio_sgs 0.73 -trim_len_edge 0 -ext_len_edge 4 -indel_balance_factor_sgs 0.66 -min_count_ratio_skip 0.31 -max_len_kmer 19 -min_len_inter_kmer 4 -max_count_kmer 93	mutated	564	24	8	0	596
NextPolish	-min_map_quality 57 -max_ins_fold_sgs 6 -max_clip_ratio_sgs 0.95 -trim_len_edge 23 -ext_len_edge 0 -indel_balance_factor_sgs 0.78 -min_count_ratio_skip 0.96 -max_len_kmer 78 -min_len_inter_kmer 10 -max_count_kmer 72	random	904	88	22	4	1018
NextPolish	-min_map_quality 18 -max_ins_fold_sgs 4 -max_clip_ratio_sgs 0.73 -trim_len_edge 1 -ext_len_edge 4 -indel_balance_factor_sgs 0.66 -min_count_ratio_skip 0.31 -max_len_kmer 18 -min_len_inter_kmer 4 -max_count_kmer 99	mutated	586	23	9	0	618
NextPolish	-min_map_quality 6 -max_ins_fold_sgs 2 -max_clip_ratio_sgs 0.03 -trim_len_edge 2 -ext_len_edge 22 -indel_balance_factor_sgs 0.06 -min_count_ratio_skip 0.4 -max_len_kmer 81 -min_len_inter_kmer 1 -max_count_kmer 98	random	603	25	11	0	639
NextPolish	-min_map_quality 18 -max_ins_fold_sgs 5 -max_clip_ratio_sgs 0.73 -trim_len_edge 0 -ext_len_edge 4 -indel_balance_factor_sgs 0.64 -min_count_ratio_skip 0.26 -max_len_kmer 19 -min_len_inter_kmer 6 -max_count_kmer 86	mutated	564	24	8	0	596
NextPolish	-min_map_quality 16 -max_ins_fold_sgs 5 -max_clip_ratio_sgs 0.78 -trim_len_edge 12 -ext_len_edge 20 -indel_balance_factor_sgs 0.8 -min_count_ratio_skip 0.54 -max_len_kmer 14 -min_len_inter_kmer 8 -max_count_kmer 87	random	700	47	14	0	761
NextPolish	-min_map_quality 55 -max_ins_fold_sgs 4 -max_clip_ratio_sgs 0.09 -trim_len_edge 1 -ext_len_edge 21 -indel_balance_factor_sgs 0.49 -min_count_ratio_skip 0.75 -max_len_kmer 19 -min_len_inter_kmer 5 -max_count_kmer 100	random	792	52	14	0	858
NextPolish	-min_map_quality 18 -max_ins_fold_sgs 5 -max_clip_ratio_sgs 0.73 -trim_len_edge 0 -ext_len_edge 4 -indel_balance_factor_sgs 0.64 -min_count_ratio_skip 0.26 -max_len_kmer 19 -min_len_inter_kmer 4 -max_count_kmer 86	mutated	564	24	8	0	596
NextPolish	-min_map_quality 43 -max_ins_fold_sgs 14 -max_clip_ratio_sgs 0.24 -trim_len_edge 0 -ext_len_edge 1 -indel_balance_factor_sgs 0.55 -min_count_ratio_skip 0.5 -max_len_kmer 85 -min_len_inter_kmer 6 -max_count_kmer 86	random	567	24	8	0	599
NextPolish	-min_map_quality 25 -max_ins_fold_sgs 11 -max_clip_ratio_sgs 0.75 -trim_len_edge 0 -ext_len_edge 2 -indel_balance_factor_sgs 0.23 -min_count_ratio_skip 0.89 -max_len_kmer 50 -min_len_inter_kmer 8 -max_count_kmer 62	random	957	86	22	3	1068
NextPolish	-min_map_quality 18 -max_ins_fold_sgs 5 -max_clip_ratio_sgs 0.73 -trim_len_edge 0 -ext_len_edge 4 -indel_balance_factor_sgs 0.64 -min_count_ratio_skip 0.33 -max_len_kmer 19 -min_len_inter_kmer 4 -max_count_kmer 86	mutated	564	24	8	0	596
NextPolish	-min_map_quality 0 -max_ins_fold_sgs 4 -max_clip_ratio_sgs 0.54 -trim_len_edge 8 -ext_len_edge 2 -indel_balance_factor_sgs 0.04 -min_count_ratio_skip 0.98 -max_len_kmer 80 -min_len_inter_kmer 8 -max_count_kmer 4	random	920	81	18	3	1022
NextPolish	-min_map_quality 18 -max_ins_fold_sgs 4 -max_clip_ratio_sgs 0.08 -trim_len_edge 4 -ext_len_edge 0 -indel_balance_factor_sgs 0.47 -min_count_ratio_skip 0.88 -max_len_kmer 48 -min_len_inter_kmer 3 -max_count_kmer 68	random	939	86	23	3	1051
NextPolish	-min_map_quality 18 -max_ins_fold_sgs 5 -max_clip_ratio_sgs 0.73 -trim_len_edge 0 -ext_len_edge 4 -indel_balance_factor_sgs 0.64 -min_count_ratio_skip 0.33 -max_len_kmer 16 -min_len_inter_kmer 4 -max_count_kmer 86	mutated	564	24	8	0	596
NextPolish	-min_map_quality 25 -max_ins_fold_sgs 2 -max_clip_ratio_sgs 0.0 -trim_len_edge 10 -ext_len_edge 1 -indel_balance_factor_sgs 0.04 -min_count_ratio_skip 0.53 -max_len_kmer 79 -min_len_inter_kmer 7 -max_count_kmer 1	random	694	36	15	0	745
NextPolish	-min_map_quality 18 -max_ins_fold_sgs 5 -max_clip_ratio_sgs 0.73 -trim_len_edge 0 -ext_len_edge 4 -indel_balance_factor_sgs 0.65 -min_count_ratio_skip 0.33 -max_len_kmer 16 -min_len_inter_kmer 4 -max_count_kmer 86	mutated	564	24	8	0	596
NextPolish	-min_map_quality 15 -max_ins_fold_sgs 14 -max_clip_ratio_sgs 0.99 -trim_len_edge 0 -ext_len_edge 14 -indel_balance_factor_sgs 0.02 -min_count_ratio_skip 0.87 -max_len_kmer 45 -min_len_inter_kmer 6 -max_count_kmer 25	random	940	84	20	3	1047
NextPolish	-min_map_quality 29 -max_ins_fold_sgs 9 -max_clip_ratio_sgs 0.05 -trim_len_edge 10 -ext_len_edge 0 -indel_balance_factor_sgs 0.11 -min_count_ratio_skip 0.49 -max_len_kmer 37 -min_len_inter_kmer 6 -max_count_kmer 97	random	824	62	21	0	907
NextPolish	-min_map_quality 18 -max_ins_fold_sgs 5 -max_clip_ratio_sgs 0.73 -trim_len_edge 0 -ext_len_edge 4 -indel_balance_factor_sgs 0.65 -min_count_ratio_skip 0.33 -max_len_kmer 10 -min_len_inter_kmer 4 -max_count_kmer 86	mutated	564	24	8	0	596
NextPolish	-min_map_quality 43 -max_ins_fold_sgs 3 -max_clip_ratio_sgs 0.16 -trim_len_edge 9 -ext_len_edge 0 -indel_balance_factor_sgs 0.87 -min_count_ratio_skip 0.83 -max_len_kmer 57 -min_len_inter_kmer 9 -max_count_kmer 77	random	910	74	19	3	1006
NextPolish	-min_map_quality 18 -max_ins_fold_sgs 5 -max_clip_ratio_sgs 0.73 -trim_len_edge 0 -ext_len_edge 4 -indel_balance_factor_sgs 0.65 -min_count_ratio_skip 0.33 -max_len_kmer 10 -min_len_inter_kmer 4 -max_count_kmer 76	mutated	564	24	8	0	596
NextPolish	-min_map_quality 21 -max_ins_fold_sgs 7 -max_clip_ratio_sgs 0.78 -trim_len_edge 0 -ext_len_edge 17 -indel_balance_factor_sgs 0.68 -min_count_ratio_skip 0.98 -max_len_kmer 24 -min_len_inter_kmer 5 -max_count_kmer 56	random	957	91	22	4	1074
NextPolish	-min_map_quality 19 -max_ins_fold_sgs 5 -max_clip_ratio_sgs 0.73 -trim_len_edge 0 -ext_len_edge 4 -indel_balance_factor_sgs 0.65 -min_count_ratio_skip 0.33 -max_len_kmer 10 -min_len_inter_kmer 4 -max_count_kmer 76	mutated	564	24	8	0	596
NextPolish	-min_map_quality 42 -max_ins_fold_sgs 3 -max_clip_ratio_sgs 0.71 -trim_len_edge 0 -ext_len_edge 0 -indel_balance_factor_sgs 0.13 -min_count_ratio_skip 0.43 -max_len_kmer 52 -min_len_inter_kmer 5 -max_count_kmer 20	random	567	24	8	0	599
NextPolish	-min_map_quality 58 -max_ins_fold_sgs 13 -max_clip_ratio_sgs 0.15 -trim_len_edge 5 -ext_len_edge 1 -indel_balance_factor_sgs 0.06 -min_count_ratio_skip 0.83 -max_len_kmer 47 -min_len_inter_kmer 2 -max_count_kmer 69	random	929	72	23	0	1024
NextPolish	-min_map_quality 19 -max_ins_fold_sgs 5 -max_clip_ratio_sgs 0.73 -trim_len_edge 0 -ext_len_edge 4 -indel_balance_factor_sgs 0.58 -min_count_ratio_skip 0.33 -max_len_kmer 10 -min_len_inter_kmer 4 -max_count_kmer 76	mutated	564	24	8	0	596
NextPolish	-min_map_quality 41 -max_ins_fold_sgs 4 -max_clip_ratio_sgs 0.33 -trim_len_edge 2 -ext_len_edge 0 -indel_balance_factor_sgs 0.41 -min_count_ratio_skip 0.94 -max_len_kmer 22 -min_len_inter_kmer 6 -max_count_kmer 49	random	945	89	21	3	1058
NextPolish	-min_map_quality 19 -max_ins_fold_sgs 5 -max_clip_ratio_sgs 0.73 -trim_len_edge 0 -ext_len_edge 4 -indel_balance_factor_sgs 0.59 -min_count_ratio_skip 0.33 -max_len_kmer 10 -min_len_inter_kmer 4 -max_count_kmer 76	mutated	564	24	8	0	596
NextPolish	-min_map_quality 26 -max_ins_fold_sgs 12 -max_clip_ratio_sgs 0.04 -trim_len_edge 0 -ext_len_edge 0 -indel_balance_factor_sgs 0.61 -min_count_ratio_skip 0.89 -max_len_kmer 96 -min_len_inter_kmer 7 -max_count_kmer 98	random	957	86	22	3	1068
NextPolish	-min_map_quality 42 -max_ins_fold_sgs 3 -max_clip_ratio_sgs 0.3 -trim_len_edge 0 -ext_len_edge 0 -indel_balance_factor_sgs 0.64 -min_count_ratio_skip 0.84 -max_len_kmer 16 -min_len_inter_kmer 2 -max_count_kmer 39	random	936	78	20	3	1037
NextPolish	-min_map_quality 19 -max_ins_fold_sgs 5 -max_clip_ratio_sgs 0.73 -trim_len_edge 0 -ext_len_edge 4 -indel_balance_factor_sgs 0.59 -min_count_ratio_skip 0.3 -max_len_kmer 10 -min_len_inter_kmer 4 -max_count_kmer 76	mutated	564	24	8	0	596
NextPolish	-min_map_quality 2 -max_ins_fold_sgs 11 -max_clip_ratio_sgs 0.66 -trim_len_edge 4 -ext_len_edge 12 -indel_balance_factor_sgs 0.39 -min_count_ratio_skip 0.45 -max_len_kmer 40 -min_len_inter_kmer 1 -max_count_kmer 11	random	652	34	15	0	701
NextPolish	-min_map_quality 32 -max_ins_fold_sgs 2 -max_clip_ratio_sgs 0.01 -trim_len_edge 5 -ext_len_edge 22 -indel_balance_factor_sgs 0.45 -min_count_ratio_skip 0.26 -max_len_kmer 11 -min_len_inter_kmer 3 -max_count_kmer 29	random	690	40	16	0	746
NextPolish	-min_map_quality 19 -max_ins_fold_sgs 3 -max_clip_ratio_sgs 0.73 -trim_len_edge 0 -ext_len_edge 4 -indel_balance_factor_sgs 0.59 -min_count_ratio_skip 0.3 -max_len_kmer 10 -min_len_inter_kmer 4 -max_count_kmer 80	mutated	564	24	8	0	596
NextPolish	-min_map_quality 10 -max_ins_fold_sgs 6 -max_clip_ratio_sgs 0.11 -trim_len_edge 17 -ext_len_edge 12 -indel_balance_factor_sgs 0.42 -min_count_ratio_skip 0.52 -max_len_kmer 100 -min_len_inter_kmer 10 -max_count_kmer 99	random	744	57	14	1	816
NextPolish	-min_map_quality 28 -max_ins_fold_sgs 3 -max_clip_ratio_sgs 0.73 -trim_len_edge 0 -ext_len_edge 4 -indel_balance_factor_sgs 0.59 -min_count_ratio_skip 0.3 -max_len_kmer 12 -min_len_inter_kmer 4 -max_count_kmer 80	mutated	564	24	8	0	596
NextPolish	-min_map_quality 59 -max_ins_fold_sgs 8 -max_clip_ratio_sgs 0.14 -trim_len_edge 0 -ext_len_edge 26 -indel_balance_factor_sgs 0.59 -min_count_ratio_skip 0.66 -max_len_kmer 58 -min_len_inter_kmer 9 -max_count_kmer 69	random	575	25	11	0	611
NextPolish	-min_map_quality 20 -max_ins_fold_sgs 3 -max_clip_ratio_sgs 0.73 -trim_len_edge 0 -ext_len_edge 4 -indel_balance_factor_sgs 0.59 -min_count_ratio_skip 0.3 -max_len_kmer 10 -min_len_inter_kmer 4 -max_count_kmer 80	mutated	564	24	8	0	596
NextPolish	-min_map_quality 18 -max_ins_fold_sgs 11 -max_clip_ratio_sgs 0.21 -trim_len_edge 19 -ext_len_edge 9 -indel_balance_factor_sgs 0.83 -min_count_ratio_skip 0.98 -max_len_kmer 84 -min_len_inter_kmer 7 -max_count_kmer 11	random	904	82	22	5	1013
NextPolish	-min_map_quality 20 -max_ins_fold_sgs 3 -max_clip_ratio_sgs 0.73 -trim_len_edge 0 -ext_len_edge 4 -indel_balance_factor_sgs 0.59 -min_count_ratio_skip 0.3 -max_len_kmer 10 -min_len_inter_kmer 4 -max_count_kmer 89	mutated	564	24	8	0	596
NextPolish	-min_map_quality 46 -max_ins_fold_sgs 16 -max_clip_ratio_sgs 0.63 -trim_len_edge 21 -ext_len_edge 17 -indel_balance_factor_sgs 0.03 -min_count_ratio_skip 0.62 -max_len_kmer 15 -min_len_inter_kmer 4 -max_count_kmer 85	random	752	57	20	1	830
NextPolish	-min_map_quality 26 -max_ins_fold_sgs 3 -max_clip_ratio_sgs 0.73 -trim_len_edge 0 -ext_len_edge 4 -indel_balance_factor_sgs 0.66 -min_count_ratio_skip 0.3 -max_len_kmer 10 -min_len_inter_kmer 4 -max_count_kmer 89	mutated	564	24	8	0	596
NextPolish	-min_map_quality 9 -max_ins_fold_sgs 14 -max_clip_ratio_sgs 0.37 -trim_len_edge 20 -ext_len_edge 2 -indel_balance_factor_sgs 0.39 -min_count_ratio_skip 0.63 -max_len_kmer 33 -min_len_inter_kmer 10 -max_count_kmer 81	random	753	55	19	1	828
NextPolish	-min_map_quality 33 -max_ins_fold_sgs 1 -max_clip_ratio_sgs 0.42 -trim_len_edge 0 -ext_len_edge 1 -indel_balance_factor_sgs 0.54 -min_count_ratio_skip 0.37 -max_len_kmer 75 -min_len_inter_kmer 1 -max_count_kmer 91	random	569	24	8	0	601
NextPolish	-min_map_quality 0 -max_ins_fold_sgs 2 -max_clip_ratio_sgs 0.29 -trim_len_edge 0 -ext_len_edge 18 -indel_balance_factor_sgs 0.12 -min_count_ratio_skip 0.69 -max_len_kmer 71 -min_len_inter_kmer 2 -max_count_kmer 7	random	777	46	13	0	836
NextPolish	-min_map_quality 26 -max_ins_fold_sgs 3 -max_clip_ratio_sgs 0.73 -trim_len_edge 2 -ext_len_edge 4 -indel_balance_factor_sgs 0.66 -min_count_ratio_skip 0.23 -max_len_kmer 10 -min_len_inter_kmer 4 -max_count_kmer 89	mutated	604	25	11	0	640
NextPolish	-min_map_quality 47 -max_ins_fold_sgs 2 -max_clip_ratio_sgs 0.0 -trim_len_edge 8 -ext_len_edge 9 -indel_balance_factor_sgs 0.38 -min_count_ratio_skip 0.54 -max_len_kmer 86 -min_len_inter_kmer 2 -max_count_kmer 8	random	677	36	15	0	728
NextPolish	-min_map_quality 26 -max_ins_fold_sgs 3 -max_clip_ratio_sgs 0.73 -trim_len_edge 2 -ext_len_edge 4 -indel_balance_factor_sgs 0.74 -min_count_ratio_skip 0.3 -max_len_kmer 10 -min_len_inter_kmer 4 -max_count_kmer 89	mutated	602	25	11	0	638
NextPolish	-min_map_quality 54 -max_ins_fold_sgs 2 -max_clip_ratio_sgs 0.27 -trim_len_edge 0 -ext_len_edge 3 -indel_balance_factor_sgs 0.5 -min_count_ratio_skip 0.52 -max_len_kmer 71 -min_len_inter_kmer 6 -max_count_kmer 34	random	563	23	10	0	596
NextPolish	-min_map_quality 54 -max_ins_fold_sgs 2 -max_clip_ratio_sgs 0.27 -trim_len_edge 0 -ext_len_edge 3 -indel_balance_factor_sgs 0.5 -min_count_ratio_skip 0.52 -max_len_kmer 75 -min_len_inter_kmer 6 -max_count_kmer 34	mutated	563	23	10	0	596
NextPolish	-min_map_quality 43 -max_ins_fold_sgs 6 -max_clip_ratio_sgs 0.01 -trim_len_edge 3 -ext_len_edge 0 -indel_balance_factor_sgs 0.24 -min_count_ratio_skip 0.39 -max_len_kmer 39 -min_len_inter_kmer 1 -max_count_kmer 8	random	633	29	12	0	674
NextPolish	-min_map_quality 54 -max_ins_fold_sgs 2 -max_clip_ratio_sgs 0.27 -trim_len_edge 0 -ext_len_edge 1 -indel_balance_factor_sgs 0.5 -min_count_ratio_skip 0.52 -max_len_kmer 75 -min_len_inter_kmer 6 -max_count_kmer 29	mutated	563	23	10	0	596
NextPolish	-min_map_quality 9 -max_ins_fold_sgs 16 -max_clip_ratio_sgs 0.04 -trim_len_edge 2 -ext_len_edge 1 -indel_balance_factor_sgs 0.36 -min_count_ratio_skip 0.77 -max_len_kmer 14 -min_len_inter_kmer 7 -max_count_kmer 42	random	879	63	18	0	960
NextPolish	-min_map_quality 54 -max_ins_fold_sgs 4 -max_clip_ratio_sgs 0.27 -trim_len_edge 0 -ext_len_edge 1 -indel_balance_factor_sgs 0.5 -min_count_ratio_skip 0.52 -max_len_kmer 75 -min_len_inter_kmer 6 -max_count_kmer 31	mutated	563	23	10	0	596
NextPolish	-min_map_quality 8 -max_ins_fold_sgs 3 -max_clip_ratio_sgs 0.05 -trim_len_edge 25 -ext_len_edge 0 -indel_balance_factor_sgs 0.03 -min_count_ratio_skip 0.5 -max_len_kmer 50 -min_len_inter_kmer 2 -max_count_kmer 82	random	1381	265	80	21	1747
NextPolish	-min_map_quality 27 -max_ins_fold_sgs 11 -max_clip_ratio_sgs 0.0 -trim_len_edge 3 -ext_len_edge 9 -indel_balance_factor_sgs 0.2 -min_count_ratio_skip 0.59 -max_len_kmer 36 -min_len_inter_kmer 1 -max_count_kmer 52	random	631	29	16	0	676
NextPolish	-min_map_quality 59 -max_ins_fold_sgs 5 -max_clip_ratio_sgs 0.11 -trim_len_edge 0 -ext_len_edge 27 -indel_balance_factor_sgs 0.79 -min_count_ratio_skip 0.99 -max_len_kmer 11 -min_len_inter_kmer 2 -max_count_kmer 66	random	957	91	22	4	1074
NextPolish	-min_map_quality 54 -max_ins_fold_sgs 4 -max_clip_ratio_sgs 0.27 -trim_len_edge 0 -ext_len_edge 1 -indel_balance_factor_sgs 0.58 -min_count_ratio_skip 0.52 -max_len_kmer 75 -min_len_inter_kmer 6 -max_count_kmer 31	mutated	563	23	10	0	596
NextPolish	-min_map_quality 30 -max_ins_fold_sgs 3 -max_clip_ratio_sgs 0.13 -trim_len_edge 0 -ext_len_edge 19 -indel_balance_factor_sgs 0.23 -min_count_ratio_skip 0.53 -max_len_kmer 79 -min_len_inter_kmer 1 -max_count_kmer 35	random	563	23	10	0	596
NextPolish	-min_map_quality 30 -max_ins_fold_sgs 3 -max_clip_ratio_sgs 0.13 -trim_len_edge 0 -ext_len_edge 19 -indel_balance_factor_sgs 0.23 -min_count_ratio_skip 0.53 -max_len_kmer 72 -min_len_inter_kmer 2 -max_count_kmer 35	mutated	563	23	10	0	596
NextPolish	-min_map_quality 8 -max_ins_fold_sgs 4 -max_clip_ratio_sgs 0.05 -trim_len_edge 1 -ext_len_edge 0 -indel_balance_factor_sgs 0.95 -min_count_ratio_skip 0.45 -max_len_kmer 54 -min_len_inter_kmer 2 -max_count_kmer 49	random	585	23	10	0	618
NextPolish	-min_map_quality 57 -max_ins_fold_sgs 11 -max_clip_ratio_sgs 0.0 -trim_len_edge 24 -ext_len_edge 2 -indel_balance_factor_sgs 0.03 -min_count_ratio_skip 0.91 -max_len_kmer 21 -min_len_inter_kmer 1 -max_count_kmer 28	random	907	86	22	3	1018
NextPolish	-min_map_quality 30 -max_ins_fold_sgs 3 -max_clip_ratio_sgs 0.13 -trim_len_edge 0 -ext_len_edge 21 -indel_balance_factor_sgs 0.23 -min_count_ratio_skip 0.53 -max_len_kmer 72 -min_len_inter_kmer 2 -max_count_kmer 35	mutated	563	23	10	0	596
NextPolish	-min_map_quality 48 -max_ins_fold_sgs 3 -max_clip_ratio_sgs 0.07 -trim_len_edge 1 -ext_len_edge 0 -indel_balance_factor_sgs 0.93 -min_count_ratio_skip 0.41 -max_len_kmer 57 -min_len_inter_kmer 1 -max_count_kmer 9	random	585	23	10	0	618
NextPolish	-min_map_quality 23 -max_ins_fold_sgs 2 -max_clip_ratio_sgs 0.62 -trim_len_edge 7 -ext_len_edge 3 -indel_balance_factor_sgs 0.32 -min_count_ratio_skip 0.43 -max_len_kmer 10 -min_len_inter_kmer 7 -max_count_kmer 90	random	723	41	18	0	782
NextPolish	-min_map_quality 30 -max_ins_fold_sgs 4 -max_clip_ratio_sgs 0.13 -trim_len_edge 0 -ext_len_edge 21 -indel_balance_factor_sgs 0.23 -min_count_ratio_skip 0.53 -max_len_kmer 78 -min_len_inter_kmer 2 -max_count_kmer 35	mutated	563	23	10	0	596
NextPolish	-min_map_quality 38 -max_ins_fold_sgs 4 -max_clip_ratio_sgs 0.82 -trim_len_edge 5 -ext_len_edge 2 -indel_balance_factor_sgs 0.35 -min_count_ratio_skip 0.15 -max_len_kmer 10 -min_len_inter_kmer 5 -max_count_kmer 65	random	694	40	16	0	750
NextPolish	-min_map_quality 35 -max_ins_fold_sgs 4 -max_clip_ratio_sgs 0.13 -trim_len_edge 0 -ext_len_edge 21 -indel_balance_factor_sgs 0.23 -min_count_ratio_skip 0.53 -max_len_kmer 76 -min_len_inter_kmer 2 -max_count_kmer 35	mutated	563	23	10	0	596
NextPolish	-min_map_quality 41 -max_ins_fold_sgs 7 -max_clip_ratio_sgs 0.62 -trim_len_edge 0 -ext_len_edge 2 -indel_balance_factor_sgs 0.45 -min_count_ratio_skip 0.56 -max_len_kmer 58 -min_len_inter_kmer 2 -max_count_kmer 54	random	563	23	10	0	596
NextPolish	-min_map_quality 41 -max_ins_fold_sgs 7 -max_clip_ratio_sgs 0.7 -trim_len_edge 0 -ext_len_edge 3 -indel_balance_factor_sgs 0.45 -min_count_ratio_skip 0.56 -max_len_kmer 58 -min_len_inter_kmer 2 -max_count_kmer 51	mutated	563	23	10	0	596
NextPolish	-min_map_quality 20 -max_ins_fold_sgs 2 -max_clip_ratio_sgs 0.0 -trim_len_edge 1 -ext_len_edge 4 -indel_balance_factor_sgs 0.07 -min_count_ratio_skip 0.29 -max_len_kmer 96 -min_len_inter_kmer 3 -max_count_kmer 10	random	586	23	9	0	618
NextPolish	-min_map_quality 41 -max_ins_fold_sgs 5 -max_clip_ratio_sgs 0.7 -trim_len_edge 0 -ext_len_edge 3 -indel_balance_factor_sgs 0.45 -min_count_ratio_skip 0.56 -max_len_kmer 58 -min_len_inter_kmer 2 -max_count_kmer 51	mutated	563	23	10	0	596
NextPolish	-min_map_quality 28 -max_ins_fold_sgs 3 -max_clip_ratio_sgs 0.77 -trim_len_edge 6 -ext_len_edge 0 -indel_balance_factor_sgs 0.95 -min_count_ratio_skip 0.95 -max_len_kmer 92 -min_len_inter_kmer 1 -max_count_kmer 8	random	938	86	22	3	1049
NextPolish	-min_map_quality 37 -max_ins_fold_sgs 5 -max_clip_ratio_sgs 0.7 -trim_len_edge 0 -ext_len_edge 3 -indel_balance_factor_sgs 0.45 -min_count_ratio_skip 0.65 -max_len_kmer 58 -min_len_inter_kmer 2 -max_count_kmer 51	mutated	575	25	11	0	611
NextPolish	-min_map_quality 23 -max_ins_fold_sgs 10 -max_clip_ratio_sgs 0.15 -trim_len_edge 0 -ext_len_edge 25 -indel_balance_factor_sgs 0.1 -min_count_ratio_skip 0.83 -max_len_kmer 23 -min_len_inter_kmer 10 -max_count_kmer 68	random	909	72	17	0	998
NextPolish	-min_map_quality 51 -max_ins_fold_sgs 2 -max_clip_ratio_sgs 0.07 -trim_len_edge 1 -ext_len_edge 26 -indel_balance_factor_sgs 0.51 -min_count_ratio_skip 0.91 -max_len_kmer 62 -min_len_inter_kmer 4 -max_count_kmer 9	random	946	86	21	3	1056
NextPolish	-min_map_quality 41 -max_ins_fold_sgs 5 -max_clip_ratio_sgs 0.7 -trim_len_edge 0 -ext_len_edge 3 -indel_balance_factor_sgs 0.45 -min_count_ratio_skip 0.47 -max_len_kmer 58 -min_len_inter_kmer 3 -max_count_kmer 51	mutated	567	24	8	0	599
NextPolish	-min_map_quality 52 -max_ins_fold_sgs 3 -max_clip_ratio_sgs 0.42 -trim_len_edge 19 -ext_len_edge 23 -indel_balance_factor_sgs 0.07 -min_count_ratio_skip 0.44 -max_len_kmer 80 -min_len_inter_kmer 5 -max_count_kmer 66	random	1168	170	49	11	1398
NextPolish	-min_map_quality 41 -max_ins_fold_sgs 5 -max_clip_ratio_sgs 0.7 -trim_len_edge 0 -ext_len_edge 1 -indel_balance_factor_sgs 0.45 -min_count_ratio_skip 0.56 -max_len_kmer 58 -min_len_inter_kmer 3 -max_count_kmer 51	mutated	563	23	10	0	596
NextPolish	-min_map_quality 43 -max_ins_fold_sgs 12 -max_clip_ratio_sgs 0.93 -trim_len_edge 0 -ext_len_edge 0 -indel_balance_factor_sgs 0.12 -min_count_ratio_skip 0.27 -max_len_kmer 17 -min_len_inter_kmer 6 -max_count_kmer 60	random	564	24	8	0	596
NextPolish	-min_map_quality 2 -max_ins_fold_sgs 10 -max_clip_ratio_sgs 0.67 -trim_len_edge 0 -ext_len_edge 14 -indel_balance_factor_sgs 0.09 -min_count_ratio_skip 0.78 -max_len_kmer 70 -min_len_inter_kmer 1 -max_count_kmer 49	random	862	62	16	0	940
NextPolish	-min_map_quality 43 -max_ins_fold_sgs 10 -max_clip_ratio_sgs 0.93 -trim_len_edge 1 -ext_len_edge 0 -indel_balance_factor_sgs 0.12 -min_count_ratio_skip 0.27 -max_len_kmer 17 -min_len_inter_kmer 6 -max_count_kmer 60	mutated	586	23	9	0	618
NextPolish	-min_map_quality 44 -max_ins_fold_sgs 16 -max_clip_ratio_sgs 0.04 -trim_len_edge 10 -ext_len_edge 13 -indel_balance_factor_sgs 0.41 -min_count_ratio_skip 0.52 -max_len_kmer 53 -min_len_inter_kmer 10 -max_count_kmer 7	random	694	36	15	0	745
NextPolish	-min_map_quality 51 -max_ins_fold_sgs 12 -max_clip_ratio_sgs 0.93 -trim_len_edge 0 -ext_len_edge 0 -indel_balance_factor_sgs 0.09 -min_count_ratio_skip 0.27 -max_len_kmer 17 -min_len_inter_kmer 6 -max_count_kmer 60	mutated	564	24	8	0	596
NextPolish	-min_map_quality 37 -max_ins_fold_sgs 9 -max_clip_ratio_sgs 0.0 -trim_len_edge 21 -ext_len_edge 4 -indel_balance_factor_sgs 0.97 -min_count_ratio_skip 0.64 -max_len_kmer 37 -min_len_inter_kmer 8 -max_count_kmer 98	random	752	57	20	1	830
NextPolish	-min_map_quality 51 -max_ins_fold_sgs 12 -max_clip_ratio_sgs 0.93 -trim_len_edge 0 -ext_len_edge 0 -indel_balance_factor_sgs 0.09 -min_count_ratio_skip 0.27 -max_len_kmer 11 -min_len_inter_kmer 6 -max_count_kmer 60	mutated	564	24	8	0	596
NextPolish	-min_map_quality 12 -max_ins_fold_sgs 3 -max_clip_ratio_sgs 0.4 -trim_len_edge 0 -ext_len_edge 4 -indel_balance_factor_sgs 0.58 -min_count_ratio_skip 0.16 -max_len_kmer 21 -min_len_inter_kmer 6 -max_count_kmer 75	random	566	24	8	0	598
NextPolish	-min_map_quality 49 -max_ins_fold_sgs 12 -max_clip_ratio_sgs 0.93 -trim_len_edge 0 -ext_len_edge 0 -indel_balance_factor_sgs 0.09 -min_count_ratio_skip 0.27 -max_len_kmer 11 -min_len_inter_kmer 6 -max_count_kmer 60	mutated	564	24	8	0	596
NextPolish	-min_map_quality 8 -max_ins_fold_sgs 1 -max_clip_ratio_sgs 0.0 -trim_len_edge 1 -ext_len_edge 1 -indel_balance_factor_sgs 0.64 -min_count_ratio_skip 0.93 -max_len_kmer 15 -min_len_inter_kmer 5 -max_count_kmer 80	random	946	89	21	3	1059
NextPolish	-min_map_quality 49 -max_ins_fold_sgs 11 -max_clip_ratio_sgs 0.93 -trim_len_edge 0 -ext_len_edge 0 -indel_balance_factor_sgs 0.06 -min_count_ratio_skip 0.27 -max_len_kmer 11 -min_len_inter_kmer 6 -max_count_kmer 60	mutated	564	24	8	0	596
NextPolish	-min_map_quality 27 -max_ins_fold_sgs 10 -max_clip_ratio_sgs 0.61 -trim_len_edge 7 -ext_len_edge 9 -indel_balance_factor_sgs 0.6 -min_count_ratio_skip 0.95 -max_len_kmer 88 -min_len_inter_kmer 8 -max_count_kmer 91	random	928	84	22	3	1037
NextPolish	-min_map_quality 49 -max_ins_fold_sgs 11 -max_clip_ratio_sgs 0.93 -trim_len_edge 0 -ext_len_edge 0 -indel_balance_factor_sgs 0.06 -min_count_ratio_skip 0.25 -max_len_kmer 10 -min_len_inter_kmer 8 -max_count_kmer 60	mutated	566	24	8	0	598
NextPolish	-min_map_quality 38 -max_ins_fold_sgs 16 -max_clip_ratio_sgs 0.11 -trim_len_edge 26 -ext_len_edge 3 -indel_balance_factor_sgs 0.51 -min_count_ratio_skip 0.88 -max_len_kmer 62 -min_len_inter_kmer 1 -max_count_kmer 1	random	916	85	23	4	1028
NextPolish	-min_map_quality 46 -max_ins_fold_sgs 11 -max_clip_ratio_sgs 0.93 -trim_len_edge 0 -ext_len_edge 0 -indel_balance_factor_sgs 0.06 -min_count_ratio_skip 0.27 -max_len_kmer 11 -min_len_inter_kmer 6 -max_count_kmer 60	mutated	564	24	8	0	596
NextPolish	-min_map_quality 1 -max_ins_fold_sgs 3 -max_clip_ratio_sgs 0.63 -trim_len_edge 1 -ext_len_edge 0 -indel_balance_factor_sgs 0.59 -min_count_ratio_skip 0.69 -max_len_kmer 17 -min_len_inter_kmer 8 -max_count_kmer 85	random	791	51	14	0	856
NextPolish	-min_map_quality 46 -max_ins_fold_sgs 11 -max_clip_ratio_sgs 0.93 -trim_len_edge 0 -ext_len_edge 0 -indel_balance_factor_sgs 0.06 -min_count_ratio_skip 0.27 -max_len_kmer 11 -min_len_inter_kmer 6 -max_count_kmer 64	mutated	564	24	8	0	596
NextPolish	-min_map_quality 2 -max_ins_fold_sgs 2 -max_clip_ratio_sgs 0.43 -trim_len_edge 6 -ext_len_edge 26 -indel_balance_factor_sgs 0.99 -min_count_ratio_skip 0.07 -max_len_kmer 58 -min_len_inter_kmer 1 -max_count_kmer 1	random	729	46	17	0	792
NextPolish	-min_map_quality 47 -max_ins_fold_sgs 9 -max_clip_ratio_sgs 0.0 -trim_len_edge 0 -ext_len_edge 3 -indel_balance_factor_sgs 0.01 -min_count_ratio_skip 0.93 -max_len_kmer 13 -min_len_inter_kmer 7 -max_count_kmer 15	random	957	91	22	3	1073
NextPolish	-min_map_quality 56 -max_ins_fold_sgs 11 -max_clip_ratio_sgs 0.93 -trim_len_edge 2 -ext_len_edge 2 -indel_balance_factor_sgs 0.06 -min_count_ratio_skip 0.27 -max_len_kmer 11 -min_len_inter_kmer 6 -max_count_kmer 64	mutated	602	25	11	0	638
NextPolish	-min_map_quality 29 -max_ins_fold_sgs 2 -max_clip_ratio_sgs 0.18 -trim_len_edge 10 -ext_len_edge 10 -indel_balance_factor_sgs 0.27 -min_count_ratio_skip 0.88 -max_len_kmer 88 -min_len_inter_kmer 2 -max_count_kmer 53	random	917	80	19	3	1019
NextPolish	-min_map_quality 46 -max_ins_fold_sgs 12 -max_clip_ratio_sgs 0.93 -trim_len_edge 0 -ext_len_edge 0 -indel_balance_factor_sgs 0.06 -min_count_ratio_skip 0.27 -max_len_kmer 11 -min_len_inter_kmer 4 -max_count_kmer 64	mutated	564	24	8	0	596
NextPolish	-min_map_quality 25 -max_ins_fold_sgs 4 -max_clip_ratio_sgs 0.0 -trim_len_edge 0 -ext_len_edge 1 -indel_balance_factor_sgs 0.31 -min_count_ratio_skip 0.25 -max_len_kmer 68 -min_len_inter_kmer 5 -max_count_kmer 53	random	566	24	8	0	598
NextPolish	-min_map_quality 46 -max_ins_fold_sgs 12 -max_clip_ratio_sgs 0.93 -trim_len_edge 0 -ext_len_edge 0 -indel_balance_factor_sgs 0.03 -min_count_ratio_skip 0.27 -max_len_kmer 11 -min_len_inter_kmer 4 -max_count_kmer 64	mutated	564	24	8	0	596
NextPolish	-min_map_quality 47 -max_ins_fold_sgs 7 -max_clip_ratio_sgs 0.01 -trim_len_edge 22 -ext_len_edge 16 -indel_balance_factor_sgs 0.51 -min_count_ratio_skip 0.53 -max_len_kmer 18 -min_len_inter_kmer 9 -max_count_kmer 44	random	756	63	19	1	839
NextPolish	-min_map_quality 23 -max_ins_fold_sgs 3 -max_clip_ratio_sgs 0.78 -trim_len_edge 9 -ext_len_edge 7 -indel_balance_factor_sgs 0.09 -min_count_ratio_skip 0.97 -max_len_kmer 95 -min_len_inter_kmer 2 -max_count_kmer 97	random	920	79	18	3	1020
NextPolish	-min_map_quality 46 -max_ins_fold_sgs 12 -max_clip_ratio_sgs 0.94 -trim_len_edge 0 -ext_len_edge 0 -indel_balance_factor_sgs 0.03 -min_count_ratio_skip 0.27 -max_len_kmer 11 -min_len_inter_kmer 4 -max_count_kmer 64	mutated	564	24	8	0	596
NextPolish	-min_map_quality 57 -max_ins_fold_sgs 2 -max_clip_ratio_sgs 0.0 -trim_len_edge 8 -ext_len_edge 3 -indel_balance_factor_sgs 0.03 -min_count_ratio_skip 0.66 -max_len_kmer 65 -min_len_inter_kmer 2 -max_count_kmer 1	random	685	37	15	0	737
NextPolish	-min_map_quality 46 -max_ins_fold_sgs 12 -max_clip_ratio_sgs 0.94 -trim_len_edge 0 -ext_len_edge 0 -indel_balance_factor_sgs 0.03 -min_count_ratio_skip 0.27 -max_len_kmer 11 -min_len_inter_kmer 4 -max_count_kmer 62	mutated	564	24	8	0	596
NextPolish	-min_map_quality 13 -max_ins_fold_sgs 3 -max_clip_ratio_sgs 0.55 -trim_len_edge 16 -ext_len_edge 0 -indel_balance_factor_sgs 0.57 -min_count_ratio_skip 0.99 -max_len_kmer 71 -min_len_inter_kmer 7 -max_count_kmer 2	random	925	85	18	3	1031
NextPolish	-min_map_quality 23 -max_ins_fold_sgs 4 -max_clip_ratio_sgs 0.07 -trim_len_edge 22 -ext_len_edge 16 -indel_balance_factor_sgs 0.82 -min_count_ratio_skip 0.94 -max_len_kmer 97 -min_len_inter_kmer 6 -max_count_kmer 16	random	892	85	22	4	1003
NextPolish	-min_map_quality 46 -max_ins_fold_sgs 13 -max_clip_ratio_sgs 0.94 -trim_len_edge 0 -ext_len_edge 1 -indel_balance_factor_sgs 0.03 -min_count_ratio_skip 0.27 -max_len_kmer 11 -min_len_inter_kmer 4 -max_count_kmer 62	mutated	564	24	8	0	596
NextPolish	-min_map_quality 4 -max_ins_fold_sgs 8 -max_clip_ratio_sgs 0.0 -trim_len_edge 23 -ext_len_edge 3 -indel_balance_factor_sgs 0.17 -min_count_ratio_skip 0.52 -max_len_kmer 10 -min_len_inter_kmer 2 -max_count_kmer 52	random	776	66	19	2	863
NextPolish	-min_map_quality 50 -max_ins_fold_sgs 13 -max_clip_ratio_sgs 0.94 -trim_len_edge 0 -ext_len_edge 1 -indel_balance_factor_sgs 0.03 -min_count_ratio_skip 0.27 -max_len_kmer 11 -min_len_inter_kmer 4 -max_count_kmer 62	mutated	564	24	8	0	596
NextPolish	-min_map_quality 14 -max_ins_fold_sgs 4 -max_clip_ratio_sgs 0.01 -trim_len_edge 2 -ext_len_edge 6 -indel_balance_factor_sgs 0.54 -min_count_ratio_skip 0.31 -max_len_kmer 37 -min_len_inter_kmer 6 -max_count_kmer 98	random	602	25	11	0	638
NextPolish	-min_map_quality 21 -max_ins_fold_sgs 4 -max_clip_ratio_sgs 0.07 -trim_len_edge 0 -ext_len_edge 0 -indel_balance_factor_sgs 0.06 -min_count_ratio_skip 0.79 -max_len_kmer 46 -min_len_inter_kmer 6 -max_count_kmer 15	random	862	62	16	0	940
NextPolish	-min_map_quality 48 -max_ins_fold_sgs 13 -max_clip_ratio_sgs 0.94 -trim_len_edge 0 -ext_len_edge 1 -indel_balance_factor_sgs 0.0 -min_count_ratio_skip 0.27 -max_len_kmer 11 -min_len_inter_kmer 2 -max_count_kmer 62	mutated	564	24	8	0	596
NextPolish	-min_map_quality 54 -max_ins_fold_sgs 15 -max_clip_ratio_sgs 0.44 -trim_len_edge 24 -ext_len_edge 1 -indel_balance_factor_sgs 0.49 -min_count_ratio_skip 0.37 -max_len_kmer 97 -min_len_inter_kmer 7 -max_count_kmer 43	random	1357	254	73	19	1703
NextPolish	-min_map_quality 56 -max_ins_fold_sgs 4 -max_clip_ratio_sgs 0.19 -trim_len_edge 0 -ext_len_edge 11 -indel_balance_factor_sgs 0.79 -min_count_ratio_skip 0.85 -max_len_kmer 11 -min_len_inter_kmer 7 -max_count_kmer 90	random	936	78	20	3	1037
NextPolish	-min_map_quality 48 -max_ins_fold_sgs 14 -max_clip_ratio_sgs 0.94 -trim_len_edge 0 -ext_len_edge 0 -indel_balance_factor_sgs 0.0 -min_count_ratio_skip 0.27 -max_len_kmer 11 -min_len_inter_kmer 1 -max_count_kmer 62	mutated	564	24	8	0	596
NextPolish	-min_map_quality 47 -max_ins_fold_sgs 15 -max_clip_ratio_sgs 0.01 -trim_len_edge 18 -ext_len_edge 2 -indel_balance_factor_sgs 0.81 -min_count_ratio_skip 0.35 -max_len_kmer 54 -min_len_inter_kmer 6 -max_count_kmer 7	random	1122	166	47	10	1345
NextPolish	-min_map_quality 17 -max_ins_fold_sgs 1 -max_clip_ratio_sgs 0.11 -trim_len_edge 0 -ext_len_edge 0 -indel_balance_factor_sgs 0.3 -min_count_ratio_skip 0.73 -max_len_kmer 47 -min_len_inter_kmer 2 -max_count_kmer 91	random	778	47	13	0	838
NextPolish	-min_map_quality 48 -max_ins_fold_sgs 14 -max_clip_ratio_sgs 0.94 -trim_len_edge 0 -ext_len_edge 1 -indel_balance_factor_sgs 0.0 -min_count_ratio_skip 0.29 -max_len_kmer 11 -min_len_inter_kmer 1 -max_count_kmer 62	mutated	564	24	8	0	596
NextPolish	-min_map_quality 9 -max_ins_fold_sgs 1 -max_clip_ratio_sgs 0.52 -trim_len_edge 0 -ext_len_edge 8 -indel_balance_factor_sgs 0.18 -min_count_ratio_skip 0.8 -max_len_kmer 88 -min_len_inter_kmer 9 -max_count_kmer 62	random	862	62	16	0	940
NextPolish	-min_map_quality 48 -max_ins_fold_sgs 14 -max_clip_ratio_sgs 0.87 -trim_len_edge 0 -ext_len_edge 1 -indel_balance_factor_sgs 0.0 -min_count_ratio_skip 0.29 -max_len_kmer 10 -min_len_inter_kmer 1 -max_count_kmer 62	mutated	564	24	8	0	596
NextPolish	-min_map_quality 48 -max_ins_fold_sgs 8 -max_clip_ratio_sgs 0.92 -trim_len_edge 0 -ext_len_edge 6 -indel_balance_factor_sgs 0.87 -min_count_ratio_skip 0.89 -max_len_kmer 83 -min_len_inter_kmer 2 -max_count_kmer 57	random	957	86	22	3	1068
NextPolish	-min_map_quality 48 -max_ins_fold_sgs 13 -max_clip_ratio_sgs 0.87 -trim_len_edge 0 -ext_len_edge 1 -indel_balance_factor_sgs 0.0 -min_count_ratio_skip 0.29 -max_len_kmer 10 -min_len_inter_kmer 1 -max_count_kmer 62	mutated	564	24	8	0	596
NextPolish	-min_map_quality 4 -max_ins_fold_sgs 11 -max_clip_ratio_sgs 0.46 -trim_len_edge 2 -ext_len_edge 8 -indel_balance_factor_sgs 0.41 -min_count_ratio_skip 0.52 -max_len_kmer 79 -min_len_inter_kmer 4 -max_count_kmer 56	random	601	25	13	0	639
NextPolish	-min_map_quality 48 -max_ins_fold_sgs 11 -max_clip_ratio_sgs 0.87 -trim_len_edge 0 -ext_len_edge 1 -indel_balance_factor_sgs 0.0 -min_count_ratio_skip 0.29 -max_len_kmer 10 -min_len_inter_kmer 1 -max_count_kmer 62	mutated	564	24	8	0	596
NextPolish	-min_map_quality 35 -max_ins_fold_sgs 1 -max_clip_ratio_sgs 0.11 -trim_len_edge 3 -ext_len_edge 25 -indel_balance_factor_sgs 0.8 -min_count_ratio_skip 0.74 -max_len_kmer 76 -min_len_inter_kmer 10 -max_count_kmer 87	random	830	56	18	0	904
NextPolish	-min_map_quality 17 -max_ins_fold_sgs 11 -max_clip_ratio_sgs 0.06 -trim_len_edge 0 -ext_len_edge 1 -indel_balance_factor_sgs 0.07 -min_count_ratio_skip 0.76 -max_len_kmer 19 -min_len_inter_kmer 4 -max_count_kmer 81	random	862	62	16	0	940
NextPolish	-min_map_quality 48 -max_ins_fold_sgs 11 -max_clip_ratio_sgs 0.87 -trim_len_edge 1 -ext_len_edge 1 -indel_balance_factor_sgs 0.0 -min_count_ratio_skip 0.33 -max_len_kmer 10 -min_len_inter_kmer 1 -max_count_kmer 62	mutated	586	23	9	0	618
NextPolish	-min_map_quality 49 -max_ins_fold_sgs 6 -max_clip_ratio_sgs 0.0 -trim_len_edge 1 -ext_len_edge 1 -indel_balance_factor_sgs 0.21 -min_count_ratio_skip 0.79 -max_len_kmer 74 -min_len_inter_kmer 2 -max_count_kmer 93	random	870	62	17	0	949
NextPolish	-min_map_quality 48 -max_ins_fold_sgs 11 -max_clip_ratio_sgs 0.81 -trim_len_edge 0 -ext_len_edge 1 -indel_balance_factor_sgs 0.0 -min_count_ratio_skip 0.31 -max_len_kmer 10 -min_len_inter_kmer 1 -max_count_kmer 62	mutated	564	24	8	0	596
NextPolish	-min_map_quality 22 -max_ins_fold_sgs 2 -max_clip_ratio_sgs 0.0 -trim_len_edge 12 -ext_len_edge 3 -indel_balance_factor_sgs 0.37 -min_count_ratio_skip 0.81 -max_len_kmer 58 -min_len_inter_kmer 4 -max_count_kmer 26	random	898	80	20	3	1001
NextPolish	-min_map_quality 47 -max_ins_fold_sgs 10 -max_clip_ratio_sgs 0.24 -trim_len_edge 1 -ext_len_edge 3 -indel_balance_factor_sgs 0.33 -min_count_ratio_skip 0.54 -max_len_kmer 55 -min_len_inter_kmer 6 -max_count_kmer 87	random	583	22	12	0	617
NextPolish	-min_map_quality 48 -max_ins_fold_sgs 11 -max_clip_ratio_sgs 0.81 -trim_len_edge 0 -ext_len_edge 1 -indel_balance_factor_sgs 0.08 -min_count_ratio_skip 0.31 -max_len_kmer 10 -min_len_inter_kmer 1 -max_count_kmer 62	mutated	564	24	8	0	596
NextPolish	-min_map_quality 16 -max_ins_fold_sgs 1 -max_clip_ratio_sgs 0.63 -trim_len_edge 12 -ext_len_edge 5 -indel_balance_factor_sgs 0.61 -min_count_ratio_skip 0.72 -max_len_kmer 60 -min_len_inter_kmer 9 -max_count_kmer 48	random	852	68	19	0	939
NextPolish	-min_map_quality 48 -max_ins_fold_sgs 11 -max_clip_ratio_sgs 0.81 -trim_len_edge 0 -ext_len_edge 1 -indel_balance_factor_sgs 0.16 -min_count_ratio_skip 0.31 -max_len_kmer 10 -min_len_inter_kmer 1 -max_count_kmer 62	mutated	564	24	8	0	596
NextPolish	-min_map_quality 40 -max_ins_fold_sgs 3 -max_clip_ratio_sgs 0.06 -trim_len_edge 12 -ext_len_edge 5 -indel_balance_factor_sgs 0.28 -min_count_ratio_skip 0.95 -max_len_kmer 68 -min_len_inter_kmer 8 -max_count_kmer 12	random	904	82	20	3	1009
NextPolish	-min_map_quality 54 -max_ins_fold_sgs 11 -max_clip_ratio_sgs 0.81 -trim_len_edge 0 -ext_len_edge 0 -indel_balance_factor_sgs 0.16 -min_count_ratio_skip 0.31 -max_len_kmer 10 -min_len_inter_kmer 1 -max_count_kmer 62	mutated	564	24	8	0	596
NextPolish	-min_map_quality 1 -max_ins_fold_sgs 7 -max_clip_ratio_sgs 0.0 -trim_len_edge 0 -ext_len_edge 0 -indel_balance_factor_sgs 0.63 -min_count_ratio_skip 0.55 -max_len_kmer 35 -min_len_inter_kmer 5 -max_count_kmer 41	random	563	23	10	0	596
NextPolish	-min_map_quality 60 -max_ins_fold_sgs 4 -max_clip_ratio_sgs 0.08 -trim_len_edge 22 -ext_len_edge 5 -indel_balance_factor_sgs 0.06 -min_count_ratio_skip 0.64 -max_len_kmer 48 -min_len_inter_kmer 10 -max_count_kmer 56	random	757	63	19	1	840
NextPolish	-min_map_quality 1 -max_ins_fold_sgs 7 -max_clip_ratio_sgs 0.0 -trim_len_edge 0 -ext_len_edge 0 -indel_balance_factor_sgs 0.63 -min_count_ratio_skip 0.55 -max_len_kmer 35 -min_len_inter_kmer 5 -max_count_kmer 47	mutated	563	23	10	0	596
NextPolish	-min_map_quality 54 -max_ins_fold_sgs 13 -max_clip_ratio_sgs 0.67 -trim_len_edge 0 -ext_len_edge 18 -indel_balance_factor_sgs 0.58 -min_count_ratio_skip 0.75 -max_len_kmer 68 -min_len_inter_kmer 7 -max_count_kmer 27	random	778	47	13	0	838
NextPolish	-min_map_quality 1 -max_ins_fold_sgs 7 -max_clip_ratio_sgs 0.0 -trim_len_edge 0 -ext_len_edge 0 -indel_balance_factor_sgs 0.63 -min_count_ratio_skip 0.55 -max_len_kmer 35 -min_len_inter_kmer 3 -max_count_kmer 47	mutated	563	23	10	0	596
NextPolish	-min_map_quality 26 -max_ins_fold_sgs 6 -max_clip_ratio_sgs 0.28 -trim_len_edge 16 -ext_len_edge 15 -indel_balance_factor_sgs 0.82 -min_count_ratio_skip 0.96 -max_len_kmer 39 -min_len_inter_kmer 9 -max_count_kmer 100	random	925	85	18	3	1031
NextPolish	-min_map_quality 1 -max_ins_fold_sgs 6 -max_clip_ratio_sgs -0.0 -trim_len_edge 0 -ext_len_edge 0 -indel_balance_factor_sgs 0.63 -min_count_ratio_skip 0.55 -max_len_kmer 35 -min_len_inter_kmer 3 -max_count_kmer 47	mutated	563	23	10	0	596
NextPolish	-min_map_quality 57 -max_ins_fold_sgs 4 -max_clip_ratio_sgs 0.04 -trim_len_edge 0 -ext_len_edge 0 -indel_balance_factor_sgs 0.09 -min_count_ratio_skip 0.85 -max_len_kmer 80 -min_len_inter_kmer 3 -max_count_kmer 82	random	936	78	20	3	1037
NextPolish	-min_map_quality 1 -max_ins_fold_sgs 6 -max_clip_ratio_sgs -0.0 -trim_len_edge 0 -ext_len_edge 0 -indel_balance_factor_sgs 0.63 -min_count_ratio_skip 0.55 -max_len_kmer 35 -min_len_inter_kmer 3 -max_count_kmer 44	mutated	563	23	10	0	596
NextPolish	-min_map_quality 43 -max_ins_fold_sgs 15 -max_clip_ratio_sgs 0.54 -trim_len_edge 0 -ext_len_edge 1 -indel_balance_factor_sgs 0.37 -min_count_ratio_skip 0.57 -max_len_kmer 58 -min_len_inter_kmer 5 -max_count_kmer 11	random	563	23	10	0	596
NextPolish	-min_map_quality 37 -max_ins_fold_sgs 15 -max_clip_ratio_sgs 0.54 -trim_len_edge 0 -ext_len_edge 1 -indel_balance_factor_sgs 0.37 -min_count_ratio_skip 0.57 -max_len_kmer 58 -min_len_inter_kmer 5 -max_count_kmer 11	mutated	563	23	10	0	596
NextPolish	-min_map_quality 43 -max_ins_fold_sgs 12 -max_clip_ratio_sgs 0.06 -trim_len_edge 0 -ext_len_edge 0 -indel_balance_factor_sgs 0.8 -min_count_ratio_skip 0.44 -max_len_kmer 18 -min_len_inter_kmer 9 -max_count_kmer 51	random	567	24	8	0	599
NextPolish	-min_map_quality 39 -max_ins_fold_sgs 15 -max_clip_ratio_sgs 0.54 -trim_len_edge 0 -ext_len_edge 1 -indel_balance_factor_sgs 0.37 -min_count_ratio_skip 0.57 -max_len_kmer 58 -min_len_inter_kmer 5 -max_count_kmer 11	mutated	563	23	10	0	596
NextPolish	-min_map_quality 57 -max_ins_fold_sgs 9 -max_clip_ratio_sgs 0.1 -trim_len_edge 0 -ext_len_edge 3 -indel_balance_factor_sgs 0.48 -min_count_ratio_skip 0.4 -max_len_kmer 26 -min_len_inter_kmer 4 -max_count_kmer 18	random	569	24	8	0	601
NextPolish	-min_map_quality 39 -max_ins_fold_sgs 15 -max_clip_ratio_sgs 0.54 -trim_len_edge 0 -ext_len_edge 1 -indel_balance_factor_sgs 0.36 -min_count_ratio_skip 0.51 -max_len_kmer 58 -min_len_inter_kmer 7 -max_count_kmer 11	mutated	563	23	10	0	596
NextPolish	-min_map_quality 43 -max_ins_fold_sgs 7 -max_clip_ratio_sgs 0.0 -trim_len_edge 11 -ext_len_edge 19 -indel_balance_factor_sgs 0.1 -min_count_ratio_skip 0.37 -max_len_kmer 27 -min_len_inter_kmer 6 -max_count_kmer 33	random	866	74	25	0	965
NextPolish	-min_map_quality 39 -max_ins_fold_sgs 17 -max_clip_ratio_sgs 0.54 -trim_len_edge 0 -ext_len_edge 1 -indel_balance_factor_sgs 0.3 -min_count_ratio_skip 0.51 -max_len_kmer 58 -min_len_inter_kmer 9 -max_count_kmer 11	mutated	563	23	10	0	596
NextPolish	-min_map_quality 17 -max_ins_fold_sgs 9 -max_clip_ratio_sgs 0.01 -trim_len_edge 0 -ext_len_edge 1 -indel_balance_factor_sgs 0.36 -min_count_ratio_skip 0.22 -max_len_kmer 10 -min_len_inter_kmer 4 -max_count_kmer 77	random	566	24	8	0	598
NextPolish	-min_map_quality 39 -max_ins_fold_sgs 17 -max_clip_ratio_sgs 0.54 -trim_len_edge 0 -ext_len_edge 1 -indel_balance_factor_sgs 0.3 -min_count_ratio_skip 0.51 -max_len_kmer 58 -min_len_inter_kmer 8 -max_count_kmer 11	mutated	563	23	10	0	596
NextPolish	-min_map_quality 37 -max_ins_fold_sgs 15 -max_clip_ratio_sgs 0.61 -trim_len_edge 10 -ext_len_edge 9 -indel_balance_factor_sgs 0.46 -min_count_ratio_skip 0.77 -max_len_kmer 40 -min_len_inter_kmer 10 -max_count_kmer 67	random	893	69	20	3	985
NextPolish	-min_map_quality 39 -max_ins_fold_sgs 17 -max_clip_ratio_sgs 0.5 -trim_len_edge 0 -ext_len_edge 1 -indel_balance_factor_sgs 0.3 -min_count_ratio_skip 0.51 -max_len_kmer 58 -min_len_inter_kmer 7 -max_count_kmer 11	mutated	563	23	10	0	596
NextPolish	-min_map_quality 45 -max_ins_fold_sgs 7 -max_clip_ratio_sgs 0.73 -trim_len_edge 0 -ext_len_edge 11 -indel_balance_factor_sgs 0.94 -min_count_ratio_skip 0.97 -max_len_kmer 41 -min_len_inter_kmer 9 -max_count_kmer 79	random	957	91	22	4	1074
NextPolish	-min_map_quality 39 -max_ins_fold_sgs 17 -max_clip_ratio_sgs 0.5 -trim_len_edge 0 -ext_len_edge 0 -indel_balance_factor_sgs 0.3 -min_count_ratio_skip 0.51 -max_len_kmer 58 -min_len_inter_kmer 7 -max_count_kmer 11	mutated	563	23	10	0	596
NextPolish	-min_map_quality 43 -max_ins_fold_sgs 10 -max_clip_ratio_sgs 0.32 -trim_len_edge 1 -ext_len_edge 7 -indel_balance_factor_sgs 0.71 -min_count_ratio_skip 0.27 -max_len_kmer 28 -min_len_inter_kmer 3 -max_count_kmer 83	random	586	23	9	0	618
NextPolish	-min_map_quality 39 -max_ins_fold_sgs 17 -max_clip_ratio_sgs 0.4 -trim_len_edge 0 -ext_len_edge 0 -indel_balance_factor_sgs 0.3 -min_count_ratio_skip 0.51 -max_len_kmer 58 -min_len_inter_kmer 7 -max_count_kmer 11	mutated	563	23	10	0	596
NextPolish	-min_map_quality 32 -max_ins_fold_sgs 8 -max_clip_ratio_sgs 0.47 -trim_len_edge 0 -ext_len_edge 10 -indel_balance_factor_sgs 0.55 -min_count_ratio_skip 0.86 -max_len_kmer 85 -min_len_inter_kmer 8 -max_count_kmer 57	random	940	84	20	3	1047
NextPolish	-min_map_quality 39 -max_ins_fold_sgs 17 -max_clip_ratio_sgs 0.4 -trim_len_edge 0 -ext_len_edge 0 -indel_balance_factor_sgs 0.36 -min_count_ratio_skip 0.51 -max_len_kmer 58 -min_len_inter_kmer 7 -max_count_kmer 2	mutated	563	23	10	0	596
NextPolish	-min_map_quality 14 -max_ins_fold_sgs 6 -max_clip_ratio_sgs 0.02 -trim_len_edge 2 -ext_len_edge 1 -indel_balance_factor_sgs 0.5 -min_count_ratio_skip 0.9 -max_len_kmer 80 -min_len_inter_kmer 2 -max_count_kmer 14	random	945	84	21	3	1053
NextPolish	-min_map_quality 39 -max_ins_fold_sgs 17 -max_clip_ratio_sgs 0.4 -trim_len_edge 0 -ext_len_edge 0 -indel_balance_factor_sgs 0.36 -min_count_ratio_skip 0.51 -max_len_kmer 59 -min_len_inter_kmer 7 -max_count_kmer 2	mutated	563	23	10	0	596
NextPolish	-min_map_quality 58 -max_ins_fold_sgs 14 -max_clip_ratio_sgs 0.45 -trim_len_edge 12 -ext_len_edge 7 -indel_balance_factor_sgs 0.31 -min_count_ratio_skip 0.42 -max_len_kmer 47 -min_len_inter_kmer 5 -max_count_kmer 63	random	887	86	26	0	999
NextPolish	-min_map_quality 39 -max_ins_fold_sgs 17 -max_clip_ratio_sgs 0.4 -trim_len_edge 2 -ext_len_edge 0 -indel_balance_factor_sgs 0.36 -min_count_ratio_skip 0.51 -max_len_kmer 59 -min_len_inter_kmer 7 -max_count_kmer 2	mutated	601	25	13	0	639
NextPolish	-min_map_quality 11 -max_ins_fold_sgs 11 -max_clip_ratio_sgs 0.0 -trim_len_edge 18 -ext_len_edge 5 -indel_balance_factor_sgs 0.33 -min_count_ratio_skip 0.91 -max_len_kmer 71 -min_len_inter_kmer 2 -max_count_kmer 88	random	915	82	21	5	1023
NextPolish	-min_map_quality 20 -max_ins_fold_sgs 6 -max_clip_ratio_sgs 0.0 -trim_len_edge 0 -ext_len_edge 4 -indel_balance_factor_sgs 0.65 -min_count_ratio_skip 0.52 -max_len_kmer 22 -min_len_inter_kmer 8 -max_count_kmer 44	random	563	23	10	0	596
NextPolish	-min_map_quality 20 -max_ins_fold_sgs 6 -max_clip_ratio_sgs 0.0 -trim_len_edge 0 -ext_len_edge 4 -indel_balance_factor_sgs 0.65 -min_count_ratio_skip 0.52 -max_len_kmer 22 -min_len_inter_kmer 8 -max_count_kmer 34	mutated	563	23	10	0	596
NextPolish	-min_map_quality 27 -max_ins_fold_sgs 8 -max_clip_ratio_sgs 0.08 -trim_len_edge 2 -ext_len_edge 7 -indel_balance_factor_sgs 0.22 -min_count_ratio_skip 0.87 -max_len_kmer 87 -min_len_inter_kmer 5 -max_count_kmer 98	random	936	82	20	3	1041
NextPolish	-min_map_quality 20 -max_ins_fold_sgs 6 -max_clip_ratio_sgs 0.05 -trim_len_edge 0 -ext_len_edge 4 -indel_balance_factor_sgs 0.65 -min_count_ratio_skip 0.52 -max_len_kmer 22 -min_len_inter_kmer 8 -max_count_kmer 34	mutated	563	23	10	0	596
NextPolish	-min_map_quality 42 -max_ins_fold_sgs 4 -max_clip_ratio_sgs 0.02 -trim_len_edge 8 -ext_len_edge 0 -indel_balance_factor_sgs 0.69 -min_count_ratio_skip 0.06 -max_len_kmer 51 -min_len_inter_kmer 9 -max_count_kmer 92	random	784	57	18	0	859
NextPolish	-min_map_quality 40 -max_ins_fold_sgs 7 -max_clip_ratio_sgs 0.13 -trim_len_edge 0 -ext_len_edge 3 -indel_balance_factor_sgs 0.48 -min_count_ratio_skip 0.62 -max_len_kmer 32 -min_len_inter_kmer 4 -max_count_kmer 66	random	575	25	11	0	611
NextPolish	-min_map_quality 32 -max_ins_fold_sgs 3 -max_clip_ratio_sgs 0.0 -trim_len_edge 4 -ext_len_edge 7 -indel_balance_factor_sgs 0.4 -min_count_ratio_skip 0.45 -max_len_kmer 17 -min_len_inter_kmer 10 -max_count_kmer 25	random	652	34	15	0	701
NextPolish	-min_map_quality 18 -max_ins_fold_sgs 6 -max_clip_ratio_sgs 0.05 -trim_len_edge 0 -ext_len_edge 6 -indel_balance_factor_sgs 0.65 -min_count_ratio_skip 0.52 -max_len_kmer 21 -min_len_inter_kmer 8 -max_count_kmer 34	mutated	563	23	10	0	596
NextPolish	-min_map_quality 13 -max_ins_fold_sgs 11 -max_clip_ratio_sgs 0.0 -trim_len_edge 6 -ext_len_edge 0 -indel_balance_factor_sgs 0.01 -min_count_ratio_skip 0.26 -max_len_kmer 66 -min_len_inter_kmer 5 -max_count_kmer 62	random	725	46	17	0	788
NextPolish	-min_map_quality 18 -max_ins_fold_sgs 6 -max_clip_ratio_sgs 0.05 -trim_len_edge 0 -ext_len_edge 6 -indel_balance_factor_sgs 0.65 -min_count_ratio_skip 0.52 -max_len_kmer 21 -min_len_inter_kmer 6 -max_count_kmer 24	mutated	563	23	10	0	596
NextPolish	-min_map_quality 41 -max_ins_fold_sgs 12 -max_clip_ratio_sgs 0.13 -trim_len_edge 1 -ext_len_edge 3 -indel_balance_factor_sgs 0.21 -min_count_ratio_skip 0.9 -max_len_kmer 57 -min_len_inter_kmer 5 -max_count_kmer 62	random	946	84	21	3	1054
NextPolish	-min_map_quality 27 -max_ins_fold_sgs 6 -max_clip_ratio_sgs 0.05 -trim_len_edge 0 -ext_len_edge 6 -indel_balance_factor_sgs 0.6 -min_count_ratio_skip 0.52 -max_len_kmer 21 -min_len_inter_kmer 6 -max_count_kmer 24	mutated	563	23	10	0	596
NextPolish	-min_map_quality 56 -max_ins_fold_sgs 5 -max_clip_ratio_sgs 0.47 -trim_len_edge 4 -ext_len_edge 19 -indel_balance_factor_sgs 0.48 -min_count_ratio_skip 0.95 -max_len_kmer 35 -min_len_inter_kmer 2 -max_count_kmer 78	random	939	88	23	3	1053
NextPolish	-min_map_quality 27 -max_ins_fold_sgs 6 -max_clip_ratio_sgs 0.05 -trim_len_edge 0 -ext_len_edge 6 -indel_balance_factor_sgs 0.6 -min_count_ratio_skip 0.52 -max_len_kmer 21 -min_len_inter_kmer 5 -max_count_kmer 24	mutated	563	23	10	0	596
NextPolish	-min_map_quality 28 -max_ins_fold_sgs 5 -max_clip_ratio_sgs 0.92 -trim_len_edge 3 -ext_len_edge 1 -indel_balance_factor_sgs 0.33 -min_count_ratio_skip 0.78 -max_len_kmer 11 -min_len_inter_kmer 4 -max_count_kmer 94	random	889	66	20	0	975
NextPolish	-min_map_quality 30 -max_ins_fold_sgs 6 -max_clip_ratio_sgs 0.05 -trim_len_edge 0 -ext_len_edge 6 -indel_balance_factor_sgs 0.6 -min_count_ratio_skip 0.52 -max_len_kmer 26 -min_len_inter_kmer 5 -max_count_kmer 27	mutated	563	23	10	0	596
NextPolish	-min_map_quality 9 -max_ins_fold_sgs 10 -max_clip_ratio_sgs 0.71 -trim_len_edge 13 -ext_len_edge 0 -indel_balance_factor_sgs 0.75 -min_count_ratio_skip 0.66 -max_len_kmer 75 -min_len_inter_kmer 4 -max_count_kmer 55	random	709	45	16	0	770
NextPolish	-min_map_quality 30 -max_ins_fold_sgs 6 -max_clip_ratio_sgs 0.0 -trim_len_edge 0 -ext_len_edge 6 -indel_balance_factor_sgs 0.6 -min_count_ratio_skip 0.52 -max_len_kmer 22 -min_len_inter_kmer 5 -max_count_kmer 27	mutated	563	23	10	0	596
NextPolish	-min_map_quality 53 -max_ins_fold_sgs 12 -max_clip_ratio_sgs 0.11 -trim_len_edge 1 -ext_len_edge 0 -indel_balance_factor_sgs 0.22 -min_count_ratio_skip 0.43 -max_len_kmer 14 -min_len_inter_kmer 9 -max_count_kmer 44	random	585	23	10	0	618
NextPolish	-min_map_quality 30 -max_ins_fold_sgs 6 -max_clip_ratio_sgs 0.0 -trim_len_edge 2 -ext_len_edge 6 -indel_balance_factor_sgs 0.6 -min_count_ratio_skip 0.52 -max_len_kmer 22 -min_len_inter_kmer 3 -max_count_kmer 27	mutated	601	25	13	0	639
NextPolish	-min_map_quality 31 -max_ins_fold_sgs 2 -max_clip_ratio_sgs 0.56 -trim_len_edge 1 -ext_len_edge 3 -indel_balance_factor_sgs 0.38 -min_count_ratio_skip 0.61 -max_len_kmer 79 -min_len_inter_kmer 5 -max_count_kmer 61	random	593	23	13	0	629
NextPolish	-min_map_quality 27 -max_ins_fold_sgs 6 -max_clip_ratio_sgs 0.0 -trim_len_edge 0 -ext_len_edge 7 -indel_balance_factor_sgs 0.6 -min_count_ratio_skip 0.58 -max_len_kmer 12 -min_len_inter_kmer 5 -max_count_kmer 27	mutated	563	23	10	0	596
NextPolish	-min_map_quality 0 -max_ins_fold_sgs 2 -max_clip_ratio_sgs 0.0 -trim_len_edge 13 -ext_len_edge 2 -indel_balance_factor_sgs 0.04 -min_count_ratio_skip 0.96 -max_len_kmer 75 -min_len_inter_kmer 6 -max_count_kmer 69	random	898	79	20	3	1000
NextPolish	-min_map_quality 50 -max_ins_fold_sgs 3 -max_clip_ratio_sgs 0.15 -trim_len_edge 6 -ext_len_edge 0 -indel_balance_factor_sgs 0.67 -min_count_ratio_skip 0.83 -max_len_kmer 62 -min_len_inter_kmer 5 -max_count_kmer 93	random	929	72	23	3	1027
NextPolish	-min_map_quality 27 -max_ins_fold_sgs 6 -max_clip_ratio_sgs 0.0 -trim_len_edge 0 -ext_len_edge 7 -indel_balance_factor_sgs 0.7 -min_count_ratio_skip 0.58 -max_len_kmer 13 -min_len_inter_kmer 5 -max_count_kmer 27	mutated	563	23	10	0	596
NextPolish	-min_map_quality 44 -max_ins_fold_sgs 6 -max_clip_ratio_sgs 0.01 -trim_len_edge 11 -ext_len_edge 2 -indel_balance_factor_sgs 0.09 -min_count_ratio_skip 0.77 -max_len_kmer 63 -min_len_inter_kmer 7 -max_count_kmer 27	random	889	68	21	3	981
NextPolish	-min_map_quality 46 -max_ins_fold_sgs 2 -max_clip_ratio_sgs 0.1 -trim_len_edge 1 -ext_len_edge 16 -indel_balance_factor_sgs 0.7 -min_count_ratio_skip 0.83 -max_len_kmer 45 -min_len_inter_kmer 3 -max_count_kmer 94	random	910	71	20	0	1001
NextPolish	-min_map_quality 27 -max_ins_fold_sgs 4 -max_clip_ratio_sgs 0.0 -trim_len_edge 0 -ext_len_edge 7 -indel_balance_factor_sgs 0.7 -min_count_ratio_skip 0.58 -max_len_kmer 13 -min_len_inter_kmer 5 -max_count_kmer 27	mutated	563	23	10	0	596
NextPolish	-min_map_quality 26 -max_ins_fold_sgs 2 -max_clip_ratio_sgs 0.05 -trim_len_edge 24 -ext_len_edge 0 -indel_balance_factor_sgs 0.16 -min_count_ratio_skip 1.0 -max_len_kmer 76 -min_len_inter_kmer 10 -max_count_kmer 8	random	907	86	22	3	1018
NextPolish	-min_map_quality 1 -max_ins_fold_sgs 3 -max_clip_ratio_sgs 0.4 -trim_len_edge 16 -ext_len_edge 14 -indel_balance_factor_sgs 0.97 -min_count_ratio_skip 0.56 -max_len_kmer 79 -min_len_inter_kmer 2 -max_count_kmer 56	random	736	53	14	0	803
NextPolish	-min_map_quality 27 -max_ins_fold_sgs 4 -max_clip_ratio_sgs 0.0 -trim_len_edge 0 -ext_len_edge 7 -indel_balance_factor_sgs 0.7 -min_count_ratio_skip 0.62 -max_len_kmer 13 -min_len_inter_kmer 5 -max_count_kmer 17	mutated	575	25	11	0	611
NextPolish	-min_map_quality 42 -max_ins_fold_sgs 15 -max_clip_ratio_sgs 0.01 -trim_len_edge 15 -ext_len_edge 25 -indel_balance_factor_sgs 0.55 -min_count_ratio_skip 0.76 -max_len_kmer 30 -min_len_inter_kmer 8 -max_count_kmer 99	random	893	81	18	3	995
NextPolish	-min_map_quality 55 -max_ins_fold_sgs 2 -max_clip_ratio_sgs 0.21 -trim_len_edge 2 -ext_len_edge 14 -indel_balance_factor_sgs 0.92 -min_count_ratio_skip 0.58 -max_len_kmer 18 -min_len_inter_kmer 4 -max_count_kmer 51	random	601	25	13	0	639
NextPolish	-min_map_quality 33 -max_ins_fold_sgs 4 -max_clip_ratio_sgs 0.0 -trim_len_edge 0 -ext_len_edge 7 -indel_balance_factor_sgs 0.7 -min_count_ratio_skip 0.58 -max_len_kmer 13 -min_len_inter_kmer 5 -max_count_kmer 30	mutated	563	23	10	0	596
NextPolish	-min_map_quality 51 -max_ins_fold_sgs 10 -max_clip_ratio_sgs 0.0 -trim_len_edge 1 -ext_len_edge 1 -indel_balance_factor_sgs 0.33 -min_count_ratio_skip 0.88 -max_len_kmer 45 -min_len_inter_kmer 10 -max_count_kmer 72	random	943	84	21	3	1051
NextPolish	-min_map_quality 31 -max_ins_fold_sgs 4 -max_clip_ratio_sgs 0.0 -trim_len_edge 0 -ext_len_edge 7 -indel_balance_factor_sgs 0.7 -min_count_ratio_skip 0.58 -max_len_kmer 13 -min_len_inter_kmer 5 -max_count_kmer 30	mutated	563	23	10	0	596
NextPolish	-min_map_quality 52 -max_ins_fold_sgs 5 -max_clip_ratio_sgs 0.11 -trim_len_edge 2 -ext_len_edge 2 -indel_balance_factor_sgs 0.97 -min_count_ratio_skip 0.46 -max_len_kmer 28 -min_len_inter_kmer 8 -max_count_kmer 22	random	603	25	11	0	639
NextPolish	-min_map_quality 31 -max_ins_fold_sgs 4 -max_clip_ratio_sgs 0.0 -trim_len_edge 0 -ext_len_edge 7 -indel_balance_factor_sgs 0.7 -min_count_ratio_skip 0.58 -max_len_kmer 13 -min_len_inter_kmer 3 -max_count_kmer 30	mutated	563	23	10	0	596
NextPolish	-min_map_quality 18 -max_ins_fold_sgs 2 -max_clip_ratio_sgs 0.01 -trim_len_edge 12 -ext_len_edge 0 -indel_balance_factor_sgs 0.62 -min_count_ratio_skip 0.18 -max_len_kmer 96 -min_len_inter_kmer 2 -max_count_kmer 54	random	918	97	30	0	1045
NextPolish	-min_map_quality 31 -max_ins_fold_sgs 4 -max_clip_ratio_sgs 0.0 -trim_len_edge 0 -ext_len_edge 7 -indel_balance_factor_sgs 0.7 -min_count_ratio_skip 0.53 -max_len_kmer 13 -min_len_inter_kmer 2 -max_count_kmer 30	mutated	563	23	10	0	596
NextPolish	-min_map_quality 8 -max_ins_fold_sgs 9 -max_clip_ratio_sgs 0.77 -trim_len_edge 1 -ext_len_edge 0 -indel_balance_factor_sgs 0.38 -min_count_ratio_skip 0.98 -max_len_kmer 75 -min_len_inter_kmer 6 -max_count_kmer 46	random	946	89	21	4	1060
NextPolish	-min_map_quality 31 -max_ins_fold_sgs 4 -max_clip_ratio_sgs 0.0 -trim_len_edge 0 -ext_len_edge 7 -indel_balance_factor_sgs 0.62 -min_count_ratio_skip 0.53 -max_len_kmer 13 -min_len_inter_kmer 2 -max_count_kmer 30	mutated	563	23	10	0	596
NextPolish	-min_map_quality 6 -max_ins_fold_sgs 2 -max_clip_ratio_sgs 0.96 -trim_len_edge 19 -ext_len_edge 16 -indel_balance_factor_sgs 0.01 -min_count_ratio_skip 0.88 -max_len_kmer 43 -min_len_inter_kmer 9 -max_count_kmer 24	random	904	82	22	5	1013
NextPolish	-min_map_quality 31 -max_ins_fold_sgs 4 -max_clip_ratio_sgs 0.0 -trim_len_edge 2 -ext_len_edge 6 -indel_balance_factor_sgs 0.62 -min_count_ratio_skip 0.53 -max_len_kmer 13 -min_len_inter_kmer 2 -max_count_kmer 30	mutated	601	25	13	0	639
NextPolish	-min_map_quality 46 -max_ins_fold_sgs 8 -max_clip_ratio_sgs 0.18 -trim_len_edge 1 -ext_len_edge 4 -indel_balance_factor_sgs 0.31 -min_count_ratio_skip 0.4 -max_len_kmer 30 -min_len_inter_kmer 6 -max_count_kmer 71	random	586	23	10	0	619
NextPolish	-min_map_quality 31 -max_ins_fold_sgs 4 -max_clip_ratio_sgs 0.0 -trim_len_edge 0 -ext_len_edge 7 -indel_balance_factor_sgs 0.68 -min_count_ratio_skip 0.53 -max_len_kmer 13 -min_len_inter_kmer 2 -max_count_kmer 30	mutated	563	23	10	0	596
NextPolish	-min_map_quality 2 -max_ins_fold_sgs 15 -max_clip_ratio_sgs 0.02 -trim_len_edge 1 -ext_len_edge 10 -indel_balance_factor_sgs 0.39 -min_count_ratio_skip 0.65 -max_len_kmer 42 -min_len_inter_kmer 3 -max_count_kmer 81	random	593	23	13	0	629
NextPolish	-min_map_quality 36 -max_ins_fold_sgs 4 -max_clip_ratio_sgs 0.0 -trim_len_edge 0 -ext_len_edge 7 -indel_balance_factor_sgs 0.68 -min_count_ratio_skip 0.63 -max_len_kmer 13 -min_len_inter_kmer 2 -max_count_kmer 30	mutated	575	25	11	0	611
NextPolish	-min_map_quality 12 -max_ins_fold_sgs 5 -max_clip_ratio_sgs 0.15 -trim_len_edge 0 -ext_len_edge 4 -indel_balance_factor_sgs 0.15 -min_count_ratio_skip 0.98 -max_len_kmer 69 -min_len_inter_kmer 3 -max_count_kmer 20	random	957	91	22	4	1074
NextPolish	-min_map_quality 29 -max_ins_fold_sgs 14 -max_clip_ratio_sgs 0.13 -trim_len_edge 13 -ext_len_edge 0 -indel_balance_factor_sgs 0.38 -min_count_ratio_skip 0.94 -max_len_kmer 70 -min_len_inter_kmer 8 -max_count_kmer 49	random	898	79	20	3	1000
NextPolish	-min_map_quality 21 -max_ins_fold_sgs 15 -max_clip_ratio_sgs 0.05 -trim_len_edge 17 -ext_len_edge 5 -indel_balance_factor_sgs 0.59 -min_count_ratio_skip 0.96 -max_len_kmer 83 -min_len_inter_kmer 6 -max_count_kmer 100	random	923	86	18	5	1032
NextPolish	-min_map_quality 31 -max_ins_fold_sgs 4 -max_clip_ratio_sgs 0.0 -trim_len_edge 0 -ext_len_edge 7 -indel_balance_factor_sgs 0.68 -min_count_ratio_skip 0.61 -max_len_kmer 13 -min_len_inter_kmer 2 -max_count_kmer 30	mutated	575	25	11	0	611
NextPolish	-min_map_quality 11 -max_ins_fold_sgs 14 -max_clip_ratio_sgs 0.98 -trim_len_edge 0 -ext_len_edge 4 -indel_balance_factor_sgs 0.43 -min_count_ratio_skip 0.51 -max_len_kmer 35 -min_len_inter_kmer 3 -max_count_kmer 54	random	563	23	10	0	596
NextPolish	-min_map_quality 29 -max_ins_fold_sgs 2 -max_clip_ratio_sgs 0.27 -trim_len_edge 21 -ext_len_edge 1 -indel_balance_factor_sgs 0.02 -min_count_ratio_skip 0.1 -max_len_kmer 55 -min_len_inter_kmer 8 -max_count_kmer 98	random	1305	229	64	17	1615
NextPolish	-min_map_quality 11 -max_ins_fold_sgs 14 -max_clip_ratio_sgs 0.98 -trim_len_edge 0 -ext_len_edge 4 -indel_balance_factor_sgs 0.43 -min_count_ratio_skip 0.51 -max_len_kmer 37 -min_len_inter_kmer 2 -max_count_kmer 54	mutated	563	23	10	0	596
NextPolish	-min_map_quality 35 -max_ins_fold_sgs 15 -max_clip_ratio_sgs 0.01 -trim_len_edge 1 -ext_len_edge 1 -indel_balance_factor_sgs 0.44 -min_count_ratio_skip 0.72 -max_len_kmer 80 -min_len_inter_kmer 5 -max_count_kmer 9	random	792	52	14	0	858
NextPolish	-min_map_quality 11 -max_ins_fold_sgs 14 -max_clip_ratio_sgs 0.98 -trim_len_edge 0 -ext_len_edge 4 -indel_balance_factor_sgs 0.43 -min_count_ratio_skip 0.48 -max_len_kmer 37 -min_len_inter_kmer 2 -max_count_kmer 54	mutated	567	24	8	0	599
NextPolish	-min_map_quality 59 -max_ins_fold_sgs 3 -max_clip_ratio_sgs 0.35 -trim_len_edge 0 -ext_len_edge 11 -indel_balance_factor_sgs 0.47 -min_count_ratio_skip 0.26 -max_len_kmer 47 -min_len_inter_kmer 5 -max_count_kmer 80	random	564	24	8	0	596
NextPolish	-min_map_quality 59 -max_ins_fold_sgs 3 -max_clip_ratio_sgs 0.35 -trim_len_edge 0 -ext_len_edge 11 -indel_balance_factor_sgs 0.48 -min_count_ratio_skip 0.26 -max_len_kmer 47 -min_len_inter_kmer 5 -max_count_kmer 80	mutated	564	24	8	0	596
NextPolish	-min_map_quality 7 -max_ins_fold_sgs 15 -max_clip_ratio_sgs 0.03 -trim_len_edge 5 -ext_len_edge 3 -indel_balance_factor_sgs 0.45 -min_count_ratio_skip 0.47 -max_len_kmer 91 -min_len_inter_kmer 3 -max_count_kmer 79	random	682	38	16	0	736
NextPolish	-min_map_quality 59 -max_ins_fold_sgs 3 -max_clip_ratio_sgs 0.35 -trim_len_edge 0 -ext_len_edge 11 -indel_balance_factor_sgs 0.48 -min_count_ratio_skip 0.26 -max_len_kmer 47 -min_len_inter_kmer 4 -max_count_kmer 80	mutated	564	24	8	0	596
NextPolish	-min_map_quality 13 -max_ins_fold_sgs 3 -max_clip_ratio_sgs 0.82 -trim_len_edge 6 -ext_len_edge 0 -indel_balance_factor_sgs 0.35 -min_count_ratio_skip 0.85 -max_len_kmer 71 -min_len_inter_kmer 4 -max_count_kmer 57	random	934	79	23	3	1039
NextPolish	-min_map_quality 1 -max_ins_fold_sgs 1 -max_clip_ratio_sgs 0.02 -trim_len_edge 7 -ext_len_edge 0 -indel_balance_factor_sgs 0.59 -min_count_ratio_skip 0.84 -max_len_kmer 86 -min_len_inter_kmer 4 -max_count_kmer 66	random	921	82	23	3	1029
NextPolish	-min_map_quality 59 -max_ins_fold_sgs 3 -max_clip_ratio_sgs 0.35 -trim_len_edge 0 -ext_len_edge 10 -indel_balance_factor_sgs 0.48 -min_count_ratio_skip 0.26 -max_len_kmer 47 -min_len_inter_kmer 4 -max_count_kmer 74	mutated	564	24	8	0	596
NextPolish	-min_map_quality 29 -max_ins_fold_sgs 11 -max_clip_ratio_sgs 0.0 -trim_len_edge 0 -ext_len_edge 2 -indel_balance_factor_sgs 0.53 -min_count_ratio_skip 0.7 -max_len_kmer 75 -min_len_inter_kmer 8 -max_count_kmer 72	random	777	46	13	0	836
NextPolish	-min_map_quality 59 -max_ins_fold_sgs 3 -max_clip_ratio_sgs 0.35 -trim_len_edge 0 -ext_len_edge 10 -indel_balance_factor_sgs 0.48 -min_count_ratio_skip 0.26 -max_len_kmer 42 -min_len_inter_kmer 4 -max_count_kmer 74	mutated	564	24	8	0	596
NextPolish	-min_map_quality 58 -max_ins_fold_sgs 12 -max_clip_ratio_sgs 0.02 -trim_len_edge 0 -ext_len_edge 17 -indel_balance_factor_sgs 0.35 -min_count_ratio_skip 0.45 -max_len_kmer 50 -min_len_inter_kmer 6 -max_count_kmer 37	random	567	24	8	0	599
NextPolish	-min_map_quality 59 -max_ins_fold_sgs 3 -max_clip_ratio_sgs 0.35 -trim_len_edge 0 -ext_len_edge 10 -indel_balance_factor_sgs 0.48 -min_count_ratio_skip 0.26 -max_len_kmer 42 -min_len_inter_kmer 6 -max_count_kmer 74	mutated	564	24	8	0	596
NextPolish	-min_map_quality 22 -max_ins_fold_sgs 2 -max_clip_ratio_sgs 0.02 -trim_len_edge 0 -ext_len_edge 0 -indel_balance_factor_sgs 0.7 -min_count_ratio_skip 0.69 -max_len_kmer 81 -min_len_inter_kmer 10 -max_count_kmer 91	random	777	46	13	0	836
NextPolish	-min_map_quality 59 -max_ins_fold_sgs 3 -max_clip_ratio_sgs 0.35 -trim_len_edge 0 -ext_len_edge 10 -indel_balance_factor_sgs 0.48 -min_count_ratio_skip 0.26 -max_len_kmer 49 -min_len_inter_kmer 6 -max_count_kmer 74	mutated	564	24	8	0	596
NextPolish	-min_map_quality 27 -max_ins_fold_sgs 1 -max_clip_ratio_sgs 0.7 -trim_len_edge 0 -ext_len_edge 0 -indel_balance_factor_sgs 0.97 -min_count_ratio_skip 0.49 -max_len_kmer 93 -min_len_inter_kmer 3 -max_count_kmer 44	random	567	24	8	0	599
NextPolish	-min_map_quality 60 -max_ins_fold_sgs 11 -max_clip_ratio_sgs 0.08 -trim_len_edge 0 -ext_len_edge 17 -indel_balance_factor_sgs 0.68 -min_count_ratio_skip 0.62 -max_len_kmer 89 -min_len_inter_kmer 3 -max_count_kmer 8	random	575	25	11	0	611
NextPolish	-min_map_quality 7 -max_ins_fold_sgs 6 -max_clip_ratio_sgs 0.12 -trim_len_edge 0 -ext_len_edge 0 -indel_balance_factor_sgs 0.58 -min_count_ratio_skip 0.32 -max_len_kmer 50 -min_len_inter_kmer 3 -max_count_kmer 64	random	564	24	8	0	596
NextPolish	-min_map_quality 27 -max_ins_fold_sgs 5 -max_clip_ratio_sgs 0.75 -trim_len_edge 1 -ext_len_edge 13 -indel_balance_factor_sgs 0.36 -min_count_ratio_skip 0.03 -max_len_kmer 66 -min_len_inter_kmer 8 -max_count_kmer 46	random	588	23	9	0	620
NextPolish	-min_map_quality 7 -max_ins_fold_sgs 6 -max_clip_ratio_sgs 0.12 -trim_len_edge 0 -ext_len_edge 0 -indel_balance_factor_sgs 0.64 -min_count_ratio_skip 0.32 -max_len_kmer 50 -min_len_inter_kmer 3 -max_count_kmer 64	mutated	564	24	8	0	596
NextPolish	-min_map_quality 38 -max_ins_fold_sgs 11 -max_clip_ratio_sgs 0.65 -trim_len_edge 16 -ext_len_edge 0 -indel_balance_factor_sgs 0.98 -min_count_ratio_skip 0.3 -max_len_kmer 14 -min_len_inter_kmer 10 -max_count_kmer 61	random	1097	156	42	4	1299
NextPolish	-min_map_quality 7 -max_ins_fold_sgs 6 -max_clip_ratio_sgs 0.12 -trim_len_edge 0 -ext_len_edge 1 -indel_balance_factor_sgs 0.64 -min_count_ratio_skip 0.32 -max_len_kmer 50 -min_len_inter_kmer 3 -max_count_kmer 64	mutated	564	24	8	0	596
NextPolish	-min_map_quality 29 -max_ins_fold_sgs 2 -max_clip_ratio_sgs 0.05 -trim_len_edge 23 -ext_len_edge 2 -indel_balance_factor_sgs 0.62 -min_count_ratio_skip 0.74 -max_len_kmer 34 -min_len_inter_kmer 7 -max_count_kmer 81	random	886	81	22	1	990
NextPolish	-min_map_quality 53 -max_ins_fold_sgs 1 -max_clip_ratio_sgs 0.03 -trim_len_edge 1 -ext_len_edge 2 -indel_balance_factor_sgs 0.84 -min_count_ratio_skip 0.8 -max_len_kmer 81 -min_len_inter_kmer 3 -max_count_kmer 82	random	870	62	17	0	949
NextPolish	-min_map_quality 6 -max_ins_fold_sgs 6 -max_clip_ratio_sgs 0.12 -trim_len_edge 0 -ext_len_edge 0 -indel_balance_factor_sgs 0.64 -min_count_ratio_skip 0.32 -max_len_kmer 50 -min_len_inter_kmer 3 -max_count_kmer 65	mutated	564	24	8	0	596
NextPolish	-min_map_quality 31 -max_ins_fold_sgs 12 -max_clip_ratio_sgs 0.99 -trim_len_edge 3 -ext_len_edge 14 -indel_balance_factor_sgs 0.64 -min_count_ratio_skip 0.65 -max_len_kmer 52 -min_len_inter_kmer 6 -max_count_kmer 33	random	640	30	16	0	686
NextPolish	-min_map_quality 22 -max_ins_fold_sgs 4 -max_clip_ratio_sgs 0.02 -trim_len_edge 14 -ext_len_edge 5 -indel_balance_factor_sgs 0.75 -min_count_ratio_skip 0.85 -max_len_kmer 55 -min_len_inter_kmer 1 -max_count_kmer 64	random	903	87	20	3	1013
NextPolish	-min_map_quality 25 -max_ins_fold_sgs 14 -max_clip_ratio_sgs 0.3 -trim_len_edge 2 -ext_len_edge 3 -indel_balance_factor_sgs 0.07 -min_count_ratio_skip 0.7 -max_len_kmer 14 -min_len_inter_kmer 1 -max_count_kmer 57	random	814	53	15	0	882
NextPolish	-min_map_quality 0 -max_ins_fold_sgs 6 -max_clip_ratio_sgs 0.12 -trim_len_edge 0 -ext_len_edge 0 -indel_balance_factor_sgs 0.64 -min_count_ratio_skip 0.32 -max_len_kmer 49 -min_len_inter_kmer 3 -max_count_kmer 65	mutated	564	24	8	0	596
NextPolish	-min_map_quality 42 -max_ins_fold_sgs 5 -max_clip_ratio_sgs 0.79 -trim_len_edge 3 -ext_len_edge 13 -indel_balance_factor_sgs 0.59 -min_count_ratio_skip 0.94 -max_len_kmer 42 -min_len_inter_kmer 9 -max_count_kmer 82	random	944	88	23	3	1058
NextPolish	-min_map_quality 0 -max_ins_fold_sgs 6 -max_clip_ratio_sgs 0.12 -trim_len_edge 0 -ext_len_edge 0 -indel_balance_factor_sgs 0.64 -min_count_ratio_skip 0.32 -max_len_kmer 53 -min_len_inter_kmer 3 -max_count_kmer 65	mutated	564	24	8	0	596
NextPolish	-min_map_quality 45 -max_ins_fold_sgs 16 -max_clip_ratio_sgs 0.05 -trim_len_edge 3 -ext_len_edge 4 -indel_balance_factor_sgs 0.63 -min_count_ratio_skip 0.66 -max_len_kmer 24 -min_len_inter_kmer 4 -max_count_kmer 80	random	640	30	16	0	686
NextPolish	-min_map_quality 0 -max_ins_fold_sgs 6 -max_clip_ratio_sgs 0.12 -trim_len_edge 0 -ext_len_edge 0 -indel_balance_factor_sgs 0.64 -min_count_ratio_skip 0.29 -max_len_kmer 53 -min_len_inter_kmer 3 -max_count_kmer 65	mutated	564	24	8	0	596
NextPolish	-min_map_quality 9 -max_ins_fold_sgs 11 -max_clip_ratio_sgs 0.0 -trim_len_edge 1 -ext_len_edge 23 -indel_balance_factor_sgs 0.93 -min_count_ratio_skip 0.47 -max_len_kmer 27 -min_len_inter_kmer 2 -max_count_kmer 72	random	585	23	10	0	618
NextPolish	-min_map_quality 0 -max_ins_fold_sgs 4 -max_clip_ratio_sgs 0.12 -trim_len_edge 0 -ext_len_edge 0 -indel_balance_factor_sgs 0.64 -min_count_ratio_skip 0.29 -max_len_kmer 53 -min_len_inter_kmer 3 -max_count_kmer 65	mutated	564	24	8	0	596
NextPolish	-min_map_quality 47 -max_ins_fold_sgs 13 -max_clip_ratio_sgs 0.02 -trim_len_edge 0 -ext_len_edge 18 -indel_balance_factor_sgs 0.17 -min_count_ratio_skip 0.33 -max_len_kmer 53 -min_len_inter_kmer 7 -max_count_kmer 4	random	564	24	8	0	596
NextPolish	-min_map_quality 47 -max_ins_fold_sgs 13 -max_clip_ratio_sgs 0.12 -trim_len_edge 0 -ext_len_edge 18 -indel_balance_factor_sgs 0.17 -min_count_ratio_skip 0.33 -max_len_kmer 53 -min_len_inter_kmer 7 -max_count_kmer 1	mutated	564	24	8	0	596
NextPolish	-min_map_quality 45 -max_ins_fold_sgs 8 -max_clip_ratio_sgs 0.59 -trim_len_edge 0 -ext_len_edge 22 -indel_balance_factor_sgs 0.99 -min_count_ratio_skip 0.75 -max_len_kmer 99 -min_len_inter_kmer 8 -max_count_kmer 1	random	778	47	13	0	838
NextPolish	-min_map_quality 47 -max_ins_fold_sgs 13 -max_clip_ratio_sgs 0.12 -trim_len_edge 0 -ext_len_edge 18 -indel_balance_factor_sgs 0.17 -min_count_ratio_skip 0.33 -max_len_kmer 53 -min_len_inter_kmer 7 -max_count_kmer 8	mutated	564	24	8	0	596
NextPolish	-min_map_quality 37 -max_ins_fold_sgs 9 -max_clip_ratio_sgs 0.52 -trim_len_edge 23 -ext_len_edge 22 -indel_balance_factor_sgs 0.63 -min_count_ratio_skip 0.69 -max_len_kmer 37 -min_len_inter_kmer 3 -max_count_kmer 46	random	886	81	22	1	990
NextPolish	-min_map_quality 47 -max_ins_fold_sgs 13 -max_clip_ratio_sgs 0.12 -trim_len_edge 0 -ext_len_edge 18 -indel_balance_factor_sgs 0.17 -min_count_ratio_skip 0.33 -max_len_kmer 53 -min_len_inter_kmer 9 -max_count_kmer 8	mutated	564	24	8	0	596
NextPolish	-min_map_quality 36 -max_ins_fold_sgs 4 -max_clip_ratio_sgs 0.4 -trim_len_edge 0 -ext_len_edge 16 -indel_balance_factor_sgs 0.67 -min_count_ratio_skip 0.37 -max_len_kmer 81 -min_len_inter_kmer 8 -max_count_kmer 62	random	569	24	8	0	601
NextPolish	-min_map_quality 47 -max_ins_fold_sgs 13 -max_clip_ratio_sgs 0.12 -trim_len_edge 0 -ext_len_edge 18 -indel_balance_factor_sgs 0.17 -min_count_ratio_skip 0.33 -max_len_kmer 53 -min_len_inter_kmer 9 -max_count_kmer 1	mutated	564	24	8	0	596
NextPolish	-min_map_quality 60 -max_ins_fold_sgs 15 -max_clip_ratio_sgs 0.25 -trim_len_edge 13 -ext_len_edge 3 -indel_balance_factor_sgs 0.55 -min_count_ratio_skip 0.35 -max_len_kmer 81 -min_len_inter_kmer 4 -max_count_kmer 54	random	931	99	31	0	1061
NextPolish	-min_map_quality 47 -max_ins_fold_sgs 13 -max_clip_ratio_sgs 0.11 -trim_len_edge 0 -ext_len_edge 18 -indel_balance_factor_sgs 0.17 -min_count_ratio_skip 0.31 -max_len_kmer 53 -min_len_inter_kmer 9 -max_count_kmer 5	mutated	564	24	8	0	596
NextPolish	-min_map_quality 39 -max_ins_fold_sgs 2 -max_clip_ratio_sgs 0.02 -trim_len_edge 25 -ext_len_edge 5 -indel_balance_factor_sgs 0.97 -min_count_ratio_skip 0.07 -max_len_kmer 50 -min_len_inter_kmer 2 -max_count_kmer 64	random	1459	307	90	29	1885
NextPolish	-min_map_quality 8 -max_ins_fold_sgs 15 -max_clip_ratio_sgs 0.0 -trim_len_edge 17 -ext_len_edge 0 -indel_balance_factor_sgs 0.34 -min_count_ratio_skip 0.99 -max_len_kmer 25 -min_len_inter_kmer 3 -max_count_kmer 46	random	923	86	18	5	1032
NextPolish	-min_map_quality 38 -max_ins_fold_sgs 2 -max_clip_ratio_sgs 0.0 -trim_len_edge 1 -ext_len_edge 16 -indel_balance_factor_sgs 0.04 -min_count_ratio_skip 0.78 -max_len_kmer 79 -min_len_inter_kmer 7 -max_count_kmer 80	random	870	62	17	0	949
NextPolish	-min_map_quality 47 -max_ins_fold_sgs 13 -max_clip_ratio_sgs 0.11 -trim_len_edge 0 -ext_len_edge 20 -indel_balance_factor_sgs 0.17 -min_count_ratio_skip 0.31 -max_len_kmer 53 -min_len_inter_kmer 9 -max_count_kmer 6	mutated	564	24	8	0	596
NextPolish	-min_map_quality 44 -max_ins_fold_sgs 4 -max_clip_ratio_sgs 0.12 -trim_len_edge 0 -ext_len_edge 12 -indel_balance_factor_sgs 0.01 -min_count_ratio_skip 0.92 -max_len_kmer 23 -min_len_inter_kmer 8 -max_count_kmer 100	random	957	91	22	3	1073
NextPolish	-min_map_quality 42 -max_ins_fold_sgs 15 -max_clip_ratio_sgs 0.11 -trim_len_edge 0 -ext_len_edge 20 -indel_balance_factor_sgs 0.17 -min_count_ratio_skip 0.31 -max_len_kmer 62 -min_len_inter_kmer 11 -max_count_kmer 6	mutated	564	24	8	0	596
NextPolish	-min_map_quality 17 -max_ins_fold_sgs 9 -max_clip_ratio_sgs 0.32 -trim_len_edge 0 -ext_len_edge 11 -indel_balance_factor_sgs 0.31 -min_count_ratio_skip 0.59 -max_len_kmer 91 -min_len_inter_kmer 9 -max_count_kmer 34	random	563	23	10	0	596
NextPolish	-min_map_quality 17 -max_ins_fold_sgs 9 -max_clip_ratio_sgs 0.32 -trim_len_edge 0 -ext_len_edge 13 -indel_balance_factor_sgs 0.31 -min_count_ratio_skip 0.59 -max_len_kmer 91 -min_len_inter_kmer 8 -max_count_kmer 34	mutated	563	23	10	0	596
NextPolish	-min_map_quality 40 -max_ins_fold_sgs 2 -max_clip_ratio_sgs 0.07 -trim_len_edge 16 -ext_len_edge 5 -indel_balance_factor_sgs 0.13 -min_count_ratio_skip 0.16 -max_len_kmer 77 -min_len_inter_kmer 7 -max_count_kmer 61	random	1100	156	42	4	1302
NextPolish	-min_map_quality 21 -max_ins_fold_sgs 13 -max_clip_ratio_sgs 0.0 -trim_len_edge 0 -ext_len_edge 15 -indel_balance_factor_sgs 0.84 -min_count_ratio_skip 0.34 -max_len_kmer 27 -min_len_inter_kmer 7 -max_count_kmer 7	random	569	24	8	0	601
NextPolish	-min_map_quality 17 -max_ins_fold_sgs 9 -max_clip_ratio_sgs 0.32 -trim_len_edge 0 -ext_len_edge 13 -indel_balance_factor_sgs 0.31 -min_count_ratio_skip 0.5 -max_len_kmer 100 -min_len_inter_kmer 8 -max_count_kmer 34	mutated	567	24	8	0	599
NextPolish	-min_map_quality 17 -max_ins_fold_sgs 14 -max_clip_ratio_sgs 0.08 -trim_len_edge 24 -ext_len_edge 8 -indel_balance_factor_sgs 0.08 -min_count_ratio_skip 0.82 -max_len_kmer 82 -min_len_inter_kmer 10 -max_count_kmer 21	random	905	85	22	3	1015
NextPolish	-min_map_quality 17 -max_ins_fold_sgs 9 -max_clip_ratio_sgs 0.32 -trim_len_edge 0 -ext_len_edge 11 -indel_balance_factor_sgs 0.31 -min_count_ratio_skip 0.59 -max_len_kmer 81 -min_len_inter_kmer 8 -max_count_kmer 34	mutated	563	23	10	0	596
NextPolish	-min_map_quality 22 -max_ins_fold_sgs 4 -max_clip_ratio_sgs 0.04 -trim_len_edge 0 -ext_len_edge 23 -indel_balance_factor_sgs 0.11 -min_count_ratio_skip 1.0 -max_len_kmer 26 -min_len_inter_kmer 3 -max_count_kmer 37	random	957	91	22	4	1074
NextPolish	-min_map_quality 17 -max_ins_fold_sgs 9 -max_clip_ratio_sgs 0.32 -trim_len_edge 0 -ext_len_edge 11 -indel_balance_factor_sgs 0.38 -min_count_ratio_skip 0.59 -max_len_kmer 81 -min_len_inter_kmer 8 -max_count_kmer 34	mutated	563	23	10	0	596
NextPolish	-min_map_quality 27 -max_ins_fold_sgs 8 -max_clip_ratio_sgs 0.0 -trim_len_edge 1 -ext_len_edge 13 -indel_balance_factor_sgs 0.63 -min_count_ratio_skip 0.72 -max_len_kmer 25 -min_len_inter_kmer 9 -max_count_kmer 18	random	792	52	14	0	858
NextPolish	-min_map_quality 17 -max_ins_fold_sgs 8 -max_clip_ratio_sgs 0.32 -trim_len_edge 0 -ext_len_edge 11 -indel_balance_factor_sgs 0.45 -min_count_ratio_skip 0.59 -max_len_kmer 81 -min_len_inter_kmer 8 -max_count_kmer 34	mutated	563	23	10	0	596
NextPolish	-min_map_quality 51 -max_ins_fold_sgs 3 -max_clip_ratio_sgs 0.02 -trim_len_edge 0 -ext_len_edge 25 -indel_balance_factor_sgs 0.22 -min_count_ratio_skip 0.42 -max_len_kmer 35 -min_len_inter_kmer 2 -max_count_kmer 1	random	568	24	8	0	600
NextPolish	-min_map_quality 17 -max_ins_fold_sgs 6 -max_clip_ratio_sgs 0.32 -trim_len_edge 0 -ext_len_edge 11 -indel_balance_factor_sgs 0.45 -min_count_ratio_skip 0.59 -max_len_kmer 81 -min_len_inter_kmer 8 -max_count_kmer 34	mutated	563	23	10	0	596
NextPolish	-min_map_quality 28 -max_ins_fold_sgs 1 -max_clip_ratio_sgs 0.0 -trim_len_edge 4 -ext_len_edge 5 -indel_balance_factor_sgs 0.82 -min_count_ratio_skip 0.74 -max_len_kmer 49 -min_len_inter_kmer 7 -max_count_kmer 95	random	843	58	18	0	919
NextPolish	-min_map_quality 17 -max_ins_fold_sgs 6 -max_clip_ratio_sgs 0.32 -trim_len_edge 0 -ext_len_edge 11 -indel_balance_factor_sgs 0.45 -min_count_ratio_skip 0.62 -max_len_kmer 81 -min_len_inter_kmer 8 -max_count_kmer 34	mutated	575	25	11	0	611
NextPolish	-min_map_quality 20 -max_ins_fold_sgs 16 -max_clip_ratio_sgs 0.0 -trim_len_edge 3 -ext_len_edge 5 -indel_balance_factor_sgs 0.92 -min_count_ratio_skip 0.65 -max_len_kmer 78 -min_len_inter_kmer 6 -max_count_kmer 5	random	640	30	16	0	686
NextPolish	-min_map_quality 17 -max_ins_fold_sgs 6 -max_clip_ratio_sgs 0.32 -trim_len_edge 0 -ext_len_edge 11 -indel_balance_factor_sgs 0.45 -min_count_ratio_skip 0.53 -max_len_kmer 81 -min_len_inter_kmer 8 -max_count_kmer 34	mutated	563	23	10	0	596
NextPolish	-min_map_quality 3 -max_ins_fold_sgs 6 -max_clip_ratio_sgs 0.11 -trim_len_edge 0 -ext_len_edge 0 -indel_balance_factor_sgs 0.76 -min_count_ratio_skip 0.72 -max_len_kmer 40 -min_len_inter_kmer 2 -max_count_kmer 72	random	778	47	13	0	838
NextPolish	-min_map_quality 17 -max_ins_fold_sgs 6 -max_clip_ratio_sgs 0.32 -trim_len_edge 0 -ext_len_edge 11 -indel_balance_factor_sgs 0.39 -min_count_ratio_skip 0.53 -max_len_kmer 81 -min_len_inter_kmer 8 -max_count_kmer 34	mutated	563	23	10	0	596
NextPolish	-min_map_quality 21 -max_ins_fold_sgs 1 -max_clip_ratio_sgs 0.09 -trim_len_edge 2 -ext_len_edge 9 -indel_balance_factor_sgs 0.74 -min_count_ratio_skip 0.89 -max_len_kmer 41 -min_len_inter_kmer 7 -max_count_kmer 88	random	945	84	21	3	1053
NextPolish	-min_map_quality 17 -max_ins_fold_sgs 6 -max_clip_ratio_sgs 0.39 -trim_len_edge 0 -ext_len_edge 11 -indel_balance_factor_sgs 0.39 -min_count_ratio_skip 0.61 -max_len_kmer 81 -min_len_inter_kmer 8 -max_count_kmer 34	mutated	575	25	11	0	611
NextPolish	-min_map_quality 55 -max_ins_fold_sgs 3 -max_clip_ratio_sgs 0.31 -trim_len_edge 12 -ext_len_edge 22 -indel_balance_factor_sgs 0.97 -min_count_ratio_skip 0.61 -max_len_kmer 26 -min_len_inter_kmer 1 -max_count_kmer 61	random	704	47	14	0	765
NextPolish	-min_map_quality 32 -max_ins_fold_sgs 11 -max_clip_ratio_sgs 0.04 -trim_len_edge 5 -ext_len_edge 1 -indel_balance_factor_sgs 0.38 -min_count_ratio_skip 0.48 -max_len_kmer 91 -min_len_inter_kmer 4 -max_count_kmer 43	random	682	38	16	0	736
NextPolish	-min_map_quality 17 -max_ins_fold_sgs 8 -max_clip_ratio_sgs 0.32 -trim_len_edge 0 -ext_len_edge 11 -indel_balance_factor_sgs 0.39 -min_count_ratio_skip 0.53 -max_len_kmer 81 -min_len_inter_kmer 8 -max_count_kmer 34	mutated	563	23	10	0	596
NextPolish	-min_map_quality 12 -max_ins_fold_sgs 3 -max_clip_ratio_sgs 0.0 -trim_len_edge 5 -ext_len_edge 0 -indel_balance_factor_sgs 0.07 -min_count_ratio_skip 0.75 -max_len_kmer 46 -min_len_inter_kmer 10 -max_count_kmer 63	random	861	59	18	0	938
NextPolish	-min_map_quality 17 -max_ins_fold_sgs 6 -max_clip_ratio_sgs 0.32 -trim_len_edge 0 -ext_len_edge 13 -indel_balance_factor_sgs 0.31 -min_count_ratio_skip 0.53 -max_len_kmer 81 -min_len_inter_kmer 8 -max_count_kmer 34	mutated	563	23	10	0	596
NextPolish	-min_map_quality 9 -max_ins_fold_sgs 2 -max_clip_ratio_sgs 0.18 -trim_len_edge 3 -ext_len_edge 0 -indel_balance_factor_sgs 0.15 -min_count_ratio_skip 0.89 -max_len_kmer 64 -min_len_inter_kmer 6 -max_count_kmer 12	random	944	86	23	3	1056
NextPolish	-min_map_quality 17 -max_ins_fold_sgs 6 -max_clip_ratio_sgs 0.32 -trim_len_edge 0 -ext_len_edge 13 -indel_balance_factor_sgs 0.31 -min_count_ratio_skip 0.53 -max_len_kmer 81 -min_len_inter_kmer 8 -max_count_kmer 26	mutated	563	23	10	0	596
NextPolish	-min_map_quality 18 -max_ins_fold_sgs 15 -max_clip_ratio_sgs 0.0 -trim_len_edge 3 -ext_len_edge 5 -indel_balance_factor_sgs 0.22 -min_count_ratio_skip 0.78 -max_len_kmer 87 -min_len_inter_kmer 10 -max_count_kmer 80	random	889	66	20	0	975
NextPolish	-min_map_quality 11 -max_ins_fold_sgs 6 -max_clip_ratio_sgs 0.32 -trim_len_edge 0 -ext_len_edge 15 -indel_balance_factor_sgs 0.31 -min_count_ratio_skip 0.53 -max_len_kmer 81 -min_len_inter_kmer 8 -max_count_kmer 26	mutated	563	23	10	0	596
NextPolish	-min_map_quality 12 -max_ins_fold_sgs 7 -max_clip_ratio_sgs 0.04 -trim_len_edge 1 -ext_len_edge 1 -indel_balance_factor_sgs 0.22 -min_count_ratio_skip 0.92 -max_len_kmer 94 -min_len_inter_kmer 8 -max_count_kmer 71	random	946	89	21	3	1059
NextPolish	-min_map_quality 11 -max_ins_fold_sgs 8 -max_clip_ratio_sgs 0.32 -trim_len_edge 0 -ext_len_edge 15 -indel_balance_factor_sgs 0.28 -min_count_ratio_skip 0.53 -max_len_kmer 84 -min_len_inter_kmer 8 -max_count_kmer 26	mutated	563	23	10	0	596
NextPolish	-min_map_quality 1 -max_ins_fold_sgs 5 -max_clip_ratio_sgs 0.79 -trim_len_edge 1 -ext_len_edge 2 -indel_balance_factor_sgs 0.88 -min_count_ratio_skip 0.43 -max_len_kmer 75 -min_len_inter_kmer 8 -max_count_kmer 71	random	585	23	10	0	618
NextPolish	-min_map_quality 5 -max_ins_fold_sgs 8 -max_clip_ratio_sgs 0.23 -trim_len_edge 0 -ext_len_edge 15 -indel_balance_factor_sgs 0.28 -min_count_ratio_skip 0.53 -max_len_kmer 84 -min_len_inter_kmer 8 -max_count_kmer 26	mutated	563	23	10	0	596
NextPolish	-min_map_quality 22 -max_ins_fold_sgs 9 -max_clip_ratio_sgs 0.07 -trim_len_edge 3 -ext_len_edge 22 -indel_balance_factor_sgs 0.36 -min_count_ratio_skip 0.94 -max_len_kmer 56 -min_len_inter_kmer 6 -max_count_kmer 89	random	944	88	23	3	1058
NextPolish	-min_map_quality 57 -max_ins_fold_sgs 10 -max_clip_ratio_sgs 0.12 -trim_len_edge 12 -ext_len_edge 6 -indel_balance_factor_sgs 0.14 -min_count_ratio_skip 0.7 -max_len_kmer 69 -min_len_inter_kmer 7 -max_count_kmer 15	random	852	68	19	0	939
NextPolish	-min_map_quality 12 -max_ins_fold_sgs 8 -max_clip_ratio_sgs 0.23 -trim_len_edge 0 -ext_len_edge 15 -indel_balance_factor_sgs 0.28 -min_count_ratio_skip 0.53 -max_len_kmer 84 -min_len_inter_kmer 8 -max_count_kmer 26	mutated	563	23	10	0	596
NextPolish	-min_map_quality 3 -max_ins_fold_sgs 11 -max_clip_ratio_sgs 0.56 -trim_len_edge 14 -ext_len_edge 2 -indel_balance_factor_sgs 0.99 -min_count_ratio_skip 0.78 -max_len_kmer 28 -min_len_inter_kmer 1 -max_count_kmer 72	random	886	84	20	3	993
NextPolish	-min_map_quality 60 -max_ins_fold_sgs 3 -max_clip_ratio_sgs 0.55 -trim_len_edge 1 -ext_len_edge 7 -indel_balance_factor_sgs 0.38 -min_count_ratio_skip 0.11 -max_len_kmer 71 -min_len_inter_kmer 2 -max_count_kmer 49	random	588	23	9	0	620
NextPolish	-min_map_quality 12 -max_ins_fold_sgs 8 -max_clip_ratio_sgs 0.23 -trim_len_edge 0 -ext_len_edge 14 -indel_balance_factor_sgs 0.28 -min_count_ratio_skip 0.53 -max_len_kmer 84 -min_len_inter_kmer 8 -max_count_kmer 26	mutated	563	23	10	0	596
NextPolish	-min_map_quality 31 -max_ins_fold_sgs 5 -max_clip_ratio_sgs 0.01 -trim_len_edge 0 -ext_len_edge 0 -indel_balance_factor_sgs 0.91 -min_count_ratio_skip 0.64 -max_len_kmer 42 -min_len_inter_kmer 8 -max_count_kmer 37	random	575	25	11	0	611
NextPolish	-min_map_quality 16 -max_ins_fold_sgs 8 -max_clip_ratio_sgs 0.23 -trim_len_edge 0 -ext_len_edge 14 -indel_balance_factor_sgs 0.28 -min_count_ratio_skip 0.53 -max_len_kmer 83 -min_len_inter_kmer 8 -max_count_kmer 26	mutated	563	23	10	0	596
NextPolish	-min_map_quality 1 -max_ins_fold_sgs 8 -max_clip_ratio_sgs 0.51 -trim_len_edge 25 -ext_len_edge 15 -indel_balance_factor_sgs 0.32 -min_count_ratio_skip 0.47 -max_len_kmer 86 -min_len_inter_kmer 5 -max_count_kmer 53	random	1381	265	80	21	1747
NextPolish	-min_map_quality 16 -max_ins_fold_sgs 8 -max_clip_ratio_sgs 0.23 -trim_len_edge 1 -ext_len_edge 14 -indel_balance_factor_sgs 0.28 -min_count_ratio_skip 0.59 -max_len_kmer 81 -min_len_inter_kmer 8 -max_count_kmer 26	mutated	583	22	12	0	617
NextPolish	-min_map_quality 28 -max_ins_fold_sgs 10 -max_clip_ratio_sgs 0.06 -trim_len_edge 0 -ext_len_edge 5 -indel_balance_factor_sgs 0.24 -min_count_ratio_skip 0.75 -max_len_kmer 43 -min_len_inter_kmer 5 -max_count_kmer 12	random	778	47	13	0	838
NextPolish	-min_map_quality 58 -max_ins_fold_sgs 13 -max_clip_ratio_sgs 0.74 -trim_len_edge 24 -ext_len_edge 1 -indel_balance_factor_sgs 0.97 -min_count_ratio_skip 0.82 -max_len_kmer 67 -min_len_inter_kmer 8 -max_count_kmer 10	random	905	85	22	3	1015
NextPolish	-min_map_quality 16 -max_ins_fold_sgs 8 -max_clip_ratio_sgs 0.25 -trim_len_edge 0 -ext_len_edge 14 -indel_balance_factor_sgs 0.28 -min_count_ratio_skip 0.53 -max_len_kmer 83 -min_len_inter_kmer 8 -max_count_kmer 26	mutated	563	23	10	0	596
NextPolish	-min_map_quality 12 -max_ins_fold_sgs 2 -max_clip_ratio_sgs 0.18 -trim_len_edge 0 -ext_len_edge 16 -indel_balance_factor_sgs 0.5 -min_count_ratio_skip 0.92 -max_len_kmer 70 -min_len_inter_kmer 3 -max_count_kmer 56	random	957	91	22	3	1073
NextPolish	-min_map_quality 16 -max_ins_fold_sgs 8 -max_clip_ratio_sgs 0.25 -trim_len_edge 1 -ext_len_edge 14 -indel_balance_factor_sgs 0.28 -min_count_ratio_skip 0.53 -max_len_kmer 83 -min_len_inter_kmer 8 -max_count_kmer 26	mutated	583	22	12	0	617
NextPolish	-min_map_quality 25 -max_ins_fold_sgs 2 -max_clip_ratio_sgs 1.0 -trim_len_edge 9 -ext_len_edge 1 -indel_balance_factor_sgs 0.59 -min_count_ratio_skip 0.9 -max_len_kmer 16 -min_len_inter_kmer 8 -max_count_kmer 39	random	920	79	18	3	1020
NextPolish	-min_map_quality 16 -max_ins_fold_sgs 8 -max_clip_ratio_sgs 0.25 -trim_len_edge 1 -ext_len_edge 15 -indel_balance_factor_sgs 0.28 -min_count_ratio_skip 0.53 -max_len_kmer 83 -min_len_inter_kmer 8 -max_count_kmer 26	mutated	583	22	12	0	617
NextPolish	-min_map_quality 55 -max_ins_fold_sgs 10 -max_clip_ratio_sgs 0.38 -trim_len_edge 18 -ext_len_edge 16 -indel_balance_factor_sgs 0.38 -min_count_ratio_skip 0.67 -max_len_kmer 54 -min_len_inter_kmer 6 -max_count_kmer 11	random	879	72	21	1	973
NextPolish	-min_map_quality 0 -max_ins_fold_sgs 5 -max_clip_ratio_sgs 0.0 -trim_len_edge 18 -ext_len_edge 6 -indel_balance_factor_sgs 0.14 -min_count_ratio_skip 0.41 -max_len_kmer 52 -min_len_inter_kmer 4 -max_count_kmer 7	random	1118	162	46	10	1336
NextPolish	-min_map_quality 16 -max_ins_fold_sgs 8 -max_clip_ratio_sgs 0.25 -trim_len_edge 0 -ext_len_edge 14 -indel_balance_factor_sgs 0.28 -min_count_ratio_skip 0.53 -max_len_kmer 83 -min_len_inter_kmer 8 -max_count_kmer 17	mutated	563	23	10	0	596
NextPolish	-min_map_quality 32 -max_ins_fold_sgs 16 -max_clip_ratio_sgs 0.33 -trim_len_edge 1 -ext_len_edge 21 -indel_balance_factor_sgs 0.39 -min_count_ratio_skip 0.66 -max_len_kmer 76 -min_len_inter_kmer 9 -max_count_kmer 85	random	593	23	13	0	629
NextPolish	-min_map_quality 43 -max_ins_fold_sgs 9 -max_clip_ratio_sgs 0.59 -trim_len_edge 1 -ext_len_edge 0 -indel_balance_factor_sgs 0.84 -min_count_ratio_skip 0.82 -max_len_kmer 97 -min_len_inter_kmer 8 -max_count_kmer 66	random	910	71	20	0	1001
NextPolish	-min_map_quality 33 -max_ins_fold_sgs 4 -max_clip_ratio_sgs 0.74 -trim_len_edge 17 -ext_len_edge 3 -indel_balance_factor_sgs 0.26 -min_count_ratio_skip 0.53 -max_len_kmer 69 -min_len_inter_kmer 4 -max_count_kmer 54	random	744	57	14	1	816
NextPolish	-min_map_quality 18 -max_ins_fold_sgs 8 -max_clip_ratio_sgs 0.25 -trim_len_edge 0 -ext_len_edge 14 -indel_balance_factor_sgs 0.25 -min_count_ratio_skip 0.53 -max_len_kmer 83 -min_len_inter_kmer 8 -max_count_kmer 17	mutated	563	23	10	0	596
NextPolish	-min_map_quality 1 -max_ins_fold_sgs 10 -max_clip_ratio_sgs 0.0 -trim_len_edge 23 -ext_len_edge 24 -indel_balance_factor_sgs 0.47 -min_count_ratio_skip 0.85 -max_len_kmer 73 -min_len_inter_kmer 9 -max_count_kmer 42	random	904	88	22	4	1018
NextPolish	-min_map_quality 18 -max_ins_fold_sgs 8 -max_clip_ratio_sgs 0.25 -trim_len_edge 0 -ext_len_edge 14 -indel_balance_factor_sgs 0.31 -min_count_ratio_skip 0.51 -max_len_kmer 83 -min_len_inter_kmer 8 -max_count_kmer 22	mutated	563	23	10	0	596
NextPolish	-min_map_quality 42 -max_ins_fold_sgs 4 -max_clip_ratio_sgs 0.02 -trim_len_edge 12 -ext_len_edge 4 -indel_balance_factor_sgs 0.42 -min_count_ratio_skip 0.78 -max_len_kmer 60 -min_len_inter_kmer 8 -max_count_kmer 55	random	886	77	20	3	986
NextPolish	-min_map_quality 18 -max_ins_fold_sgs 8 -max_clip_ratio_sgs 0.25 -trim_len_edge 0 -ext_len_edge 14 -indel_balance_factor_sgs 0.31 -min_count_ratio_skip 0.57 -max_len_kmer 83 -min_len_inter_kmer 8 -max_count_kmer 22	mutated	563	23	10	0	596
NextPolish	-min_map_quality 3 -max_ins_fold_sgs 15 -max_clip_ratio_sgs 0.79 -trim_len_edge 2 -ext_len_edge 2 -indel_balance_factor_sgs 0.87 -min_count_ratio_skip 0.14 -max_len_kmer 30 -min_len_inter_kmer 4 -max_count_kmer 8	random	604	25	11	0	640
NextPolish	-min_map_quality 18 -max_ins_fold_sgs 8 -max_clip_ratio_sgs 0.25 -trim_len_edge 0 -ext_len_edge 14 -indel_balance_factor_sgs 0.31 -min_count_ratio_skip 0.57 -max_len_kmer 90 -min_len_inter_kmer 10 -max_count_kmer 22	mutated	563	23	10	0	596
NextPolish	-min_map_quality 30 -max_ins_fold_sgs 7 -max_clip_ratio_sgs 0.73 -trim_len_edge 7 -ext_len_edge 16 -indel_balance_factor_sgs 0.9 -min_count_ratio_skip 0.81 -max_len_kmer 53 -min_len_inter_kmer 3 -max_count_kmer 88	random	918	72	23	3	1016
NextPolish	-min_map_quality 18 -max_ins_fold_sgs 8 -max_clip_ratio_sgs 0.25 -trim_len_edge 0 -ext_len_edge 14 -indel_balance_factor_sgs 0.4 -min_count_ratio_skip 0.57 -max_len_kmer 90 -min_len_inter_kmer 11 -max_count_kmer 22	mutated	563	23	10	0	596
NextPolish	-min_map_quality 35 -max_ins_fold_sgs 7 -max_clip_ratio_sgs 0.03 -trim_len_edge 4 -ext_len_edge 1 -indel_balance_factor_sgs 0.44 -min_count_ratio_skip 0.67 -max_len_kmer 88 -min_len_inter_kmer 1 -max_count_kmer 55	random	843	58	18	0	919
NextPolish	-min_map_quality 13 -max_ins_fold_sgs 8 -max_clip_ratio_sgs 0.25 -trim_len_edge 0 -ext_len_edge 14 -indel_balance_factor_sgs 0.4 -min_count_ratio_skip 0.61 -max_len_kmer 90 -min_len_inter_kmer 11 -max_count_kmer 22	mutated	575	25	11	0	611
NextPolish	-min_map_quality 17 -max_ins_fold_sgs 3 -max_clip_ratio_sgs 0.0 -trim_len_edge 4 -ext_len_edge 17 -indel_balance_factor_sgs 0.94 -min_count_ratio_skip 0.93 -max_len_kmer 16 -min_len_inter_kmer 2 -max_count_kmer 70	random	939	88	23	3	1053
NextPolish	-min_map_quality 18 -max_ins_fold_sgs 8 -max_clip_ratio_sgs 0.25 -trim_len_edge 0 -ext_len_edge 13 -indel_balance_factor_sgs 0.4 -min_count_ratio_skip 0.57 -max_len_kmer 97 -min_len_inter_kmer 9 -max_count_kmer 22	mutated	563	23	10	0	596
NextPolish	-min_map_quality 8 -max_ins_fold_sgs 15 -max_clip_ratio_sgs 0.7 -trim_len_edge 0 -ext_len_edge 1 -indel_balance_factor_sgs 0.89 -min_count_ratio_skip 0.88 -max_len_kmer 28 -min_len_inter_kmer 8 -max_count_kmer 13	random	954	86	22	3	1065
NextPolish	-min_map_quality 17 -max_ins_fold_sgs 8 -max_clip_ratio_sgs 0.25 -trim_len_edge 1 -ext_len_edge 13 -indel_balance_factor_sgs 0.4 -min_count_ratio_skip 0.57 -max_len_kmer 106 -min_len_inter_kmer 9 -max_count_kmer 22	mutated	583	22	12	0	617
NextPolish	-min_map_quality 54 -max_ins_fold_sgs 3 -max_clip_ratio_sgs 0.84 -trim_len_edge 0 -ext_len_edge 1 -indel_balance_factor_sgs 0.22 -min_count_ratio_skip 0.45 -max_len_kmer 82 -min_len_inter_kmer 7 -max_count_kmer 27	random	567	24	8	0	599
NextPolish	-min_map_quality 31 -max_ins_fold_sgs 1 -max_clip_ratio_sgs 0.13 -trim_len_edge 11 -ext_len_edge 0 -indel_balance_factor_sgs 0.39 -min_count_ratio_skip 0.78 -max_len_kmer 42 -min_len_inter_kmer 8 -max_count_kmer 90	random	889	68	21	3	981
NextPolish	-min_map_quality 1 -max_ins_fold_sgs 4 -max_clip_ratio_sgs 0.11 -trim_len_edge 0 -ext_len_edge 12 -indel_balance_factor_sgs 0.36 -min_count_ratio_skip 0.73 -max_len_kmer 99 -min_len_inter_kmer 9 -max_count_kmer 76	random	778	47	13	0	838
NextPolish	-min_map_quality 46 -max_ins_fold_sgs 1 -max_clip_ratio_sgs 0.59 -trim_len_edge 2 -ext_len_edge 16 -indel_balance_factor_sgs 0.76 -min_count_ratio_skip 0.78 -max_len_kmer 24 -min_len_inter_kmer 8 -max_count_kmer 44	random	879	63	18	0	960
NextPolish	-min_map_quality 18 -max_ins_fold_sgs 8 -max_clip_ratio_sgs 0.25 -trim_len_edge 0 -ext_len_edge 13 -indel_balance_factor_sgs 0.4 -min_count_ratio_skip 0.66 -max_len_kmer 97 -min_len_inter_kmer 9 -max_count_kmer 22	mutated	575	25	11	0	611
NextPolish	-min_map_quality 38 -max_ins_fold_sgs 2 -max_clip_ratio_sgs 0.2 -trim_len_edge 15 -ext_len_edge 9 -indel_balance_factor_sgs 0.28 -min_count_ratio_skip 0.57 -max_len_kmer 66 -min_len_inter_kmer 2 -max_count_kmer 100	random	722	53	14	0	789
NextPolish	-min_map_quality 18 -max_ins_fold_sgs 10 -max_clip_ratio_sgs 0.25 -trim_len_edge 0 -ext_len_edge 15 -indel_balance_factor_sgs 0.4 -min_count_ratio_skip 0.57 -max_len_kmer 97 -min_len_inter_kmer 9 -max_count_kmer 21	mutated	563	23	10	0	596
NextPolish	-min_map_quality 41 -max_ins_fold_sgs 15 -max_clip_ratio_sgs 0.0 -trim_len_edge 9 -ext_len_edge 25 -indel_balance_factor_sgs 0.01 -min_count_ratio_skip 0.89 -max_len_kmer 99 -min_len_inter_kmer 10 -max_count_kmer 92	random	920	79	18	3	1020
NextPolish	-min_map_quality 18 -max_ins_fold_sgs 10 -max_clip_ratio_sgs 0.25 -trim_len_edge 2 -ext_len_edge 17 -indel_balance_factor_sgs 0.4 -min_count_ratio_skip 0.57 -max_len_kmer 97 -min_len_inter_kmer 10 -max_count_kmer 21	mutated	601	25	13	0	639
NextPolish	-min_map_quality 24 -max_ins_fold_sgs 4 -max_clip_ratio_sgs 0.0 -trim_len_edge 1 -ext_len_edge 3 -indel_balance_factor_sgs 0.24 -min_count_ratio_skip 0.31 -max_len_kmer 48 -min_len_inter_kmer 3 -max_count_kmer 82	random	586	23	9	0	618
NextPolish	-min_map_quality 18 -max_ins_fold_sgs 11 -max_clip_ratio_sgs 0.25 -trim_len_edge 0 -ext_len_edge 15 -indel_balance_factor_sgs 0.4 -min_count_ratio_skip 0.57 -max_len_kmer 97 -min_len_inter_kmer 9 -max_count_kmer 21	mutated	563	23	10	0	596
NextPolish	-min_map_quality 46 -max_ins_fold_sgs 10 -max_clip_ratio_sgs 0.53 -trim_len_edge 0 -ext_len_edge 21 -indel_balance_factor_sgs 0.74 -min_count_ratio_skip 0.4 -max_len_kmer 98 -min_len_inter_kmer 10 -max_count_kmer 15	random	569	24	8	0	601
NextPolish	-min_map_quality 18 -max_ins_fold_sgs 11 -max_clip_ratio_sgs 0.25 -trim_len_edge 0 -ext_len_edge 15 -indel_balance_factor_sgs 0.4 -min_count_ratio_skip 0.57 -max_len_kmer 97 -min_len_inter_kmer 11 -max_count_kmer 31	mutated	563	23	10	0	596
NextPolish	-min_map_quality 5 -max_ins_fold_sgs 3 -max_clip_ratio_sgs 0.31 -trim_len_edge 0 -ext_len_edge 0 -indel_balance_factor_sgs 0.16 -min_count_ratio_skip 0.98 -max_len_kmer 16 -min_len_inter_kmer 6 -max_count_kmer 31	random	957	91	22	4	1074
NextPolish	-min_map_quality 18 -max_ins_fold_sgs 11 -max_clip_ratio_sgs 0.25 -trim_len_edge 0 -ext_len_edge 13 -indel_balance_factor_sgs 0.4 -min_count_ratio_skip 0.57 -max_len_kmer 97 -min_len_inter_kmer 10 -max_count_kmer 31	mutated	563	23	10	0	596
NextPolish	-min_map_quality 23 -max_ins_fold_sgs 7 -max_clip_ratio_sgs 0.29 -trim_len_edge 16 -ext_len_edge 0 -indel_balance_factor_sgs 0.34 -min_count_ratio_skip 0.82 -max_len_kmer 54 -min_len_inter_kmer 9 -max_count_kmer 6	random	919	83	18	3	1023
NextPolish	-min_map_quality 18 -max_ins_fold_sgs 11 -max_clip_ratio_sgs 0.25 -trim_len_edge 0 -ext_len_edge 13 -indel_balance_factor_sgs 0.4 -min_count_ratio_skip 0.57 -max_len_kmer 97 -min_len_inter_kmer 8 -max_count_kmer 31	mutated	563	23	10	0	596
NextPolish	-min_map_quality 19 -max_ins_fold_sgs 11 -max_clip_ratio_sgs 0.4 -trim_len_edge 0 -ext_len_edge 3 -indel_balance_factor_sgs 0.67 -min_count_ratio_skip 0.7 -max_len_kmer 13 -min_len_inter_kmer 4 -max_count_kmer 26	random	777	46	13	0	836
NextPolish	-min_map_quality 18 -max_ins_fold_sgs 11 -max_clip_ratio_sgs 0.25 -trim_len_edge 0 -ext_len_edge 13 -indel_balance_factor_sgs 0.4 -min_count_ratio_skip 0.57 -max_len_kmer 90 -min_len_inter_kmer 8 -max_count_kmer 31	mutated	563	23	10	0	596
NextPolish	-min_map_quality 58 -max_ins_fold_sgs 4 -max_clip_ratio_sgs 0.08 -trim_len_edge 21 -ext_len_edge 6 -indel_balance_factor_sgs 0.8 -min_count_ratio_skip 0.88 -max_len_kmer 49 -min_len_inter_kmer 1 -max_count_kmer 11	random	889	80	23	4	996
NextPolish	-min_map_quality 18 -max_ins_fold_sgs 11 -max_clip_ratio_sgs 0.25 -trim_len_edge 0 -ext_len_edge 15 -indel_balance_factor_sgs 0.4 -min_count_ratio_skip 0.62 -max_len_kmer 90 -min_len_inter_kmer 8 -max_count_kmer 31	mutated	575	25	11	0	611
NextPolish	-min_map_quality 32 -max_ins_fold_sgs 11 -max_clip_ratio_sgs 0.14 -trim_len_edge 0 -ext_len_edge 23 -indel_balance_factor_sgs 0.55 -min_count_ratio_skip 0.72 -max_len_kmer 72 -min_len_inter_kmer 3 -max_count_kmer 49	random	778	47	13	0	838
NextPolish	-min_map_quality 29 -max_ins_fold_sgs 5 -max_clip_ratio_sgs 0.07 -trim_len_edge 3 -ext_len_edge 2 -indel_balance_factor_sgs 0.51 -min_count_ratio_skip 0.77 -max_len_kmer 69 -min_len_inter_kmer 8 -max_count_kmer 37	random	889	66	20	0	975
NextPolish	-min_map_quality 18 -max_ins_fold_sgs 11 -max_clip_ratio_sgs 0.25 -trim_len_edge 0 -ext_len_edge 13 -indel_balance_factor_sgs 0.4 -min_count_ratio_skip 0.57 -max_len_kmer 90 -min_len_inter_kmer 7 -max_count_kmer 31	mutated	563	23	10	0	596
NextPolish	-min_map_quality 48 -max_ins_fold_sgs 6 -max_clip_ratio_sgs 0.0 -trim_len_edge 0 -ext_len_edge 0 -indel_balance_factor_sgs 0.83 -min_count_ratio_skip 0.14 -max_len_kmer 78 -min_len_inter_kmer 2 -max_count_kmer 54	random	566	24	8	0	598
NextPolish	-min_map_quality 18 -max_ins_fold_sgs 11 -max_clip_ratio_sgs 0.25 -trim_len_edge 0 -ext_len_edge 12 -indel_balance_factor_sgs 0.4 -min_count_ratio_skip 0.57 -max_len_kmer 90 -min_len_inter_kmer 7 -max_count_kmer 31	mutated	563	23	10	0	596
NextPolish	-min_map_quality 41 -max_ins_fold_sgs 4 -max_clip_ratio_sgs 0.21 -trim_len_edge 8 -ext_len_edge 1 -indel_balance_factor_sgs 0.16 -min_count_ratio_skip 0.92 -max_len_kmer 56 -min_len_inter_kmer 10 -max_count_kmer 55	random	920	81	18	3	1022
NextPolish	-min_map_quality 17 -max_ins_fold_sgs 12 -max_clip_ratio_sgs 0.25 -trim_len_edge 0 -ext_len_edge 12 -indel_balance_factor_sgs 0.4 -min_count_ratio_skip 0.57 -max_len_kmer 84 -min_len_inter_kmer 7 -max_count_kmer 31	mutated	563	23	10	0	596
NextPolish	-min_map_quality 10 -max_ins_fold_sgs 3 -max_clip_ratio_sgs 0.08 -trim_len_edge 7 -ext_len_edge 1 -indel_balance_factor_sgs 0.0 -min_count_ratio_skip 0.73 -max_len_kmer 13 -min_len_inter_kmer 9 -max_count_kmer 61	random	857	59	21	0	937
NextPolish	-min_map_quality 25 -max_ins_fold_sgs 1 -max_clip_ratio_sgs 0.51 -trim_len_edge 7 -ext_len_edge 12 -indel_balance_factor_sgs 0.78 -min_count_ratio_skip 0.35 -max_len_kmer 92 -min_len_inter_kmer 2 -max_count_kmer 16	random	725	44	18	0	787
NextPolish	-min_map_quality 17 -max_ins_fold_sgs 10 -max_clip_ratio_sgs 0.26 -trim_len_edge 0 -ext_len_edge 12 -indel_balance_factor_sgs 0.4 -min_count_ratio_skip 0.62 -max_len_kmer 84 -min_len_inter_kmer 7 -max_count_kmer 31	mutated	575	25	11	0	611
NextPolish	-min_map_quality 48 -max_ins_fold_sgs 8 -max_clip_ratio_sgs 0.07 -trim_len_edge 2 -ext_len_edge 4 -indel_balance_factor_sgs 0.45 -min_count_ratio_skip 0.45 -max_len_kmer 35 -min_len_inter_kmer 1 -max_count_kmer 90	random	603	25	11	0	639
NextPolish	-min_map_quality 17 -max_ins_fold_sgs 12 -max_clip_ratio_sgs 0.25 -trim_len_edge 0 -ext_len_edge 12 -indel_balance_factor_sgs 0.44 -min_count_ratio_skip 0.57 -max_len_kmer 84 -min_len_inter_kmer 7 -max_count_kmer 27	mutated	563	23	10	0	596
NextPolish	-min_map_quality 32 -max_ins_fold_sgs 3 -max_clip_ratio_sgs 0.17 -trim_len_edge 2 -ext_len_edge 6 -indel_balance_factor_sgs 0.19 -min_count_ratio_skip 0.39 -max_len_kmer 56 -min_len_inter_kmer 9 -max_count_kmer 34	random	603	25	11	0	639
NextPolish	-min_map_quality 52 -max_ins_fold_sgs 2 -max_clip_ratio_sgs 0.04 -trim_len_edge 12 -ext_len_edge 11 -indel_balance_factor_sgs 0.76 -min_count_ratio_skip 0.48 -max_len_kmer 79 -min_len_inter_kmer 1 -max_count_kmer 13	random	887	86	26	0	999
NextPolish	-min_map_quality 55 -max_ins_fold_sgs 2 -max_clip_ratio_sgs 0.01 -trim_len_edge 2 -ext_len_edge 1 -indel_balance_factor_sgs 0.38 -min_count_ratio_skip 0.71 -max_len_kmer 43 -min_len_inter_kmer 8 -max_count_kmer 76	random	814	53	15	0	882
NextPolish	-min_map_quality 17 -max_ins_fold_sgs 12 -max_clip_ratio_sgs 0.25 -trim_len_edge 0 -ext_len_edge 12 -indel_balance_factor_sgs 0.44 -min_count_ratio_skip 0.57 -max_len_kmer 84 -min_len_inter_kmer 7 -max_count_kmer 25	mutated	563	23	10	0	596
NextPolish	-min_map_quality 55 -max_ins_fold_sgs 8 -max_clip_ratio_sgs 0.02 -trim_len_edge 25 -ext_len_edge 25 -indel_balance_factor_sgs 0.81 -min_count_ratio_skip 0.65 -max_len_kmer 71 -min_len_inter_kmer 10 -max_count_kmer 59	random	785	66	20	1	872
NextPolish	-min_map_quality 20 -max_ins_fold_sgs 14 -max_clip_ratio_sgs 0.01 -trim_len_edge 0 -ext_len_edge 6 -indel_balance_factor_sgs 0.13 -min_count_ratio_skip 0.42 -max_len_kmer 18 -min_len_inter_kmer 3 -max_count_kmer 88	random	568	24	8	0	600
NextPolish	-min_map_quality 39 -max_ins_fold_sgs 12 -max_clip_ratio_sgs 0.85 -trim_len_edge 0 -ext_len_edge 3 -indel_balance_factor_sgs 0.94 -min_count_ratio_skip 0.51 -max_len_kmer 37 -min_len_inter_kmer 10 -max_count_kmer 80	random	563	23	10	0	596
NextPolish	-min_map_quality 39 -max_ins_fold_sgs 12 -max_clip_ratio_sgs 0.85 -trim_len_edge 0 -ext_len_edge 3 -indel_balance_factor_sgs 0.87 -min_count_ratio_skip 0.51 -max_len_kmer 37 -min_len_inter_kmer 10 -max_count_kmer 80	mutated	563	23	10	0	596
NextPolish	-min_map_quality 11 -max_ins_fold_sgs 2 -max_clip_ratio_sgs 0.04 -trim_len_edge 17 -ext_len_edge 4 -indel_balance_factor_sgs 0.02 -min_count_ratio_skip 0.86 -max_len_kmer 24 -min_len_inter_kmer 7 -max_count_kmer 99	random	922	86	18	4	1030
NextPolish	-min_map_quality 29 -max_ins_fold_sgs 10 -max_clip_ratio_sgs 0.85 -trim_len_edge 0 -ext_len_edge 3 -indel_balance_factor_sgs 0.87 -min_count_ratio_skip 0.51 -max_len_kmer 37 -min_len_inter_kmer 10 -max_count_kmer 82	mutated	563	23	10	0	596
NextPolish	-min_map_quality 13 -max_ins_fold_sgs 4 -max_clip_ratio_sgs 0.16 -trim_len_edge 2 -ext_len_edge 1 -indel_balance_factor_sgs 0.54 -min_count_ratio_skip 0.48 -max_len_kmer 55 -min_len_inter_kmer 4 -max_count_kmer 61	random	603	25	11	0	639
NextPolish	-min_map_quality 29 -max_ins_fold_sgs 10 -max_clip_ratio_sgs 0.85 -trim_len_edge 0 -ext_len_edge 4 -indel_balance_factor_sgs 0.87 -min_count_ratio_skip 0.51 -max_len_kmer 37 -min_len_inter_kmer 9 -max_count_kmer 82	mutated	563	23	10	0	596
NextPolish	-min_map_quality 28 -max_ins_fold_sgs 12 -max_clip_ratio_sgs 0.34 -trim_len_edge 0 -ext_len_edge 21 -indel_balance_factor_sgs 0.46 -min_count_ratio_skip 0.98 -max_len_kmer 85 -min_len_inter_kmer 8 -max_count_kmer 45	random	957	91	22	4	1074
NextPolish	-min_map_quality 29 -max_ins_fold_sgs 10 -max_clip_ratio_sgs 0.85 -trim_len_edge 0 -ext_len_edge 4 -indel_balance_factor_sgs 0.87 -min_count_ratio_skip 0.51 -max_len_kmer 37 -min_len_inter_kmer 9 -max_count_kmer 88	mutated	563	23	10	0	596
NextPolish	-min_map_quality 3 -max_ins_fold_sgs 2 -max_clip_ratio_sgs 0.8 -trim_len_edge 2 -ext_len_edge 0 -indel_balance_factor_sgs 0.84 -min_count_ratio_skip 0.67 -max_len_kmer 73 -min_len_inter_kmer 8 -max_count_kmer 49	random	814	53	15	0	882
NextPolish	-min_map_quality 29 -max_ins_fold_sgs 10 -max_clip_ratio_sgs 0.85 -trim_len_edge 0 -ext_len_edge 4 -indel_balance_factor_sgs 0.87 -min_count_ratio_skip 0.43 -max_len_kmer 37 -min_len_inter_kmer 9 -max_count_kmer 88	mutated	567	24	8	0	599
NextPolish	-min_map_quality 59 -max_ins_fold_sgs 6 -max_clip_ratio_sgs 0.03 -trim_len_edge 7 -ext_len_edge 1 -indel_balance_factor_sgs 0.4 -min_count_ratio_skip 0.65 -max_len_kmer 57 -min_len_inter_kmer 4 -max_count_kmer 67	random	685	37	16	0	738
NextPolish	-min_map_quality 29 -max_ins_fold_sgs 8 -max_clip_ratio_sgs 0.85 -trim_len_edge 0 -ext_len_edge 4 -indel_balance_factor_sgs 0.84 -min_count_ratio_skip 0.49 -max_len_kmer 37 -min_len_inter_kmer 9 -max_count_kmer 88	mutated	567	24	8	0	599
NextPolish	-min_map_quality 3 -max_ins_fold_sgs 2 -max_clip_ratio_sgs 0.27 -trim_len_edge 11 -ext_len_edge 6 -indel_balance_factor_sgs 0.07 -min_count_ratio_skip 0.72 -max_len_kmer 71 -min_len_inter_kmer 6 -max_count_kmer 87	random	851	59	19	0	929
NextPolish	-min_map_quality 29 -max_ins_fold_sgs 10 -max_clip_ratio_sgs 0.85 -trim_len_edge 1 -ext_len_edge 5 -indel_balance_factor_sgs 0.87 -min_count_ratio_skip 0.51 -max_len_kmer 37 -min_len_inter_kmer 9 -max_count_kmer 81	mutated	583	22	12	0	617
NextPolish	-min_map_quality 12 -max_ins_fold_sgs 11 -max_clip_ratio_sgs 0.03 -trim_len_edge 0 -ext_len_edge 5 -indel_balance_factor_sgs 0.52 -min_count_ratio_skip 0.58 -max_len_kmer 16 -min_len_inter_kmer 5 -max_count_kmer 60	random	563	23	10	0	596
NextPolish	-min_map_quality 22 -max_ins_fold_sgs 11 -max_clip_ratio_sgs 0.03 -trim_len_edge 0 -ext_len_edge 5 -indel_balance_factor_sgs 0.52 -min_count_ratio_skip 0.58 -max_len_kmer 16 -min_len_inter_kmer 5 -max_count_kmer 66	mutated	563	23	10	0	596
NextPolish	-min_map_quality 16 -max_ins_fold_sgs 15 -max_clip_ratio_sgs 0.35 -trim_len_edge 17 -ext_len_edge 7 -indel_balance_factor_sgs 0.36 -min_count_ratio_skip 0.52 -max_len_kmer 42 -min_len_inter_kmer 6 -max_count_kmer 34	random	744	57	14	1	816
NextPolish	-min_map_quality 26 -max_ins_fold_sgs 11 -max_clip_ratio_sgs 0.11 -trim_len_edge 0 -ext_len_edge 5 -indel_balance_factor_sgs 0.52 -min_count_ratio_skip 0.58 -max_len_kmer 16 -min_len_inter_kmer 5 -max_count_kmer 66	mutated	563	23	10	0	596
NextPolish	-min_map_quality 12 -max_ins_fold_sgs 15 -max_clip_ratio_sgs 0.1 -trim_len_edge 8 -ext_len_edge 0 -indel_balance_factor_sgs 0.47 -min_count_ratio_skip 0.63 -max_len_kmer 34 -min_len_inter_kmer 9 -max_count_kmer 84	random	685	37	15	0	737
NextPolish	-min_map_quality 26 -max_ins_fold_sgs 11 -max_clip_ratio_sgs 0.12 -trim_len_edge 0 -ext_len_edge 5 -indel_balance_factor_sgs 0.52 -min_count_ratio_skip 0.58 -max_len_kmer 16 -min_len_inter_kmer 7 -max_count_kmer 66	mutated	563	23	10	0	596
NextPolish	-min_map_quality 20 -max_ins_fold_sgs 2 -max_clip_ratio_sgs 0.0 -trim_len_edge 0 -ext_len_edge 1 -indel_balance_factor_sgs 0.49 -min_count_ratio_skip 0.79 -max_len_kmer 23 -min_len_inter_kmer 6 -max_count_kmer 27	random	862	62	16	0	940
NextPolish	-min_map_quality 35 -max_ins_fold_sgs 11 -max_clip_ratio_sgs 0.12 -trim_len_edge 0 -ext_len_edge 4 -indel_balance_factor_sgs 0.58 -min_count_ratio_skip 0.58 -max_len_kmer 16 -min_len_inter_kmer 7 -max_count_kmer 66	mutated	563	23	10	0	596
NextPolish	-min_map_quality 36 -max_ins_fold_sgs 14 -max_clip_ratio_sgs 0.16 -trim_len_edge 12 -ext_len_edge 2 -indel_balance_factor_sgs 0.21 -min_count_ratio_skip 0.69 -max_len_kmer 30 -min_len_inter_kmer 7 -max_count_kmer 3	random	852	68	19	0	939
NextPolish	-min_map_quality 35 -max_ins_fold_sgs 11 -max_clip_ratio_sgs 0.14 -trim_len_edge 0 -ext_len_edge 4 -indel_balance_factor_sgs 0.58 -min_count_ratio_skip 0.58 -max_len_kmer 16 -min_len_inter_kmer 7 -max_count_kmer 66	mutated	563	23	10	0	596
NextPolish	-min_map_quality 26 -max_ins_fold_sgs 9 -max_clip_ratio_sgs 0.01 -trim_len_edge 0 -ext_len_edge 0 -indel_balance_factor_sgs 0.56 -min_count_ratio_skip 0.97 -max_len_kmer 86 -min_len_inter_kmer 2 -max_count_kmer 21	random	957	91	22	4	1074
NextPolish	-min_map_quality 25 -max_ins_fold_sgs 10 -max_clip_ratio_sgs 0.0 -trim_len_edge 3 -ext_len_edge 11 -indel_balance_factor_sgs 0.93 -min_count_ratio_skip 0.67 -max_len_kmer 26 -min_len_inter_kmer 7 -max_count_kmer 4	random	829	56	18	0	903
NextPolish	-min_map_quality 29 -max_ins_fold_sgs 11 -max_clip_ratio_sgs 0.14 -trim_len_edge 0 -ext_len_edge 3 -indel_balance_factor_sgs 0.58 -min_count_ratio_skip 0.58 -max_len_kmer 16 -min_len_inter_kmer 7 -max_count_kmer 66	mutated	563	23	10	0	596
NextPolish	-min_map_quality 40 -max_ins_fold_sgs 4 -max_clip_ratio_sgs 0.28 -trim_len_edge 1 -ext_len_edge 0 -indel_balance_factor_sgs 0.48 -min_count_ratio_skip 0.95 -max_len_kmer 40 -min_len_inter_kmer 5 -max_count_kmer 78	random	946	89	21	3	1059
NextPolish	-min_map_quality 29 -max_ins_fold_sgs 11 -max_clip_ratio_sgs 0.14 -trim_len_edge 0 -ext_len_edge 3 -indel_balance_factor_sgs 0.58 -min_count_ratio_skip 0.58 -max_len_kmer 16 -min_len_inter_kmer 7 -max_count_kmer 67	mutated	563	23	10	0	596
NextPolish	-min_map_quality 6 -max_ins_fold_sgs 3 -max_clip_ratio_sgs 0.03 -trim_len_edge 2 -ext_len_edge 3 -indel_balance_factor_sgs 0.12 -min_count_ratio_skip 0.9 -max_len_kmer 71 -min_len_inter_kmer 5 -max_count_kmer 31	random	945	84	21	3	1053
NextPolish	-min_map_quality 29 -max_ins_fold_sgs 11 -max_clip_ratio_sgs 0.14 -trim_len_edge 0 -ext_len_edge 3 -indel_balance_factor_sgs 0.58 -min_count_ratio_skip 0.59 -max_len_kmer 13 -min_len_inter_kmer 7 -max_count_kmer 67	mutated	563	23	10	0	596
NextPolish	-min_map_quality 27 -max_ins_fold_sgs 6 -max_clip_ratio_sgs 0.31 -trim_len_edge 2 -ext_len_edge 5 -indel_balance_factor_sgs 0.75 -min_count_ratio_skip 0.5 -max_len_kmer 38 -min_len_inter_kmer 2 -max_count_kmer 46	random	603	25	11	0	639
NextPolish	-min_map_quality 29 -max_ins_fold_sgs 11 -max_clip_ratio_sgs 0.23 -trim_len_edge 0 -ext_len_edge 4 -indel_balance_factor_sgs 0.58 -min_count_ratio_skip 0.68 -max_len_kmer 13 -min_len_inter_kmer 7 -max_count_kmer 70	mutated	777	46	13	0	836
NextPolish	-min_map_quality 9 -max_ins_fold_sgs 5 -max_clip_ratio_sgs 0.04 -trim_len_edge 23 -ext_len_edge 14 -indel_balance_factor_sgs 0.8 -min_count_ratio_skip 0.35 -max_len_kmer 19 -min_len_inter_kmer 3 -max_count_kmer 87	random	1324	233	62	20	1639
NextPolish	-min_map_quality 22 -max_ins_fold_sgs 11 -max_clip_ratio_sgs 0.14 -trim_len_edge 0 -ext_len_edge 3 -indel_balance_factor_sgs 0.58 -min_count_ratio_skip 0.59 -max_len_kmer 13 -min_len_inter_kmer 5 -max_count_kmer 67	mutated	563	23	10	0	596
NextPolish	-min_map_quality 59 -max_ins_fold_sgs 15 -max_clip_ratio_sgs 0.0 -trim_len_edge 4 -ext_len_edge 1 -indel_balance_factor_sgs 0.99 -min_count_ratio_skip 0.64 -max_len_kmer 75 -min_len_inter_kmer 4 -max_count_kmer 40	random	657	34	16	0	707
NextPolish	-min_map_quality 22 -max_ins_fold_sgs 11 -max_clip_ratio_sgs 0.14 -trim_len_edge 0 -ext_len_edge 3 -indel_balance_factor_sgs 0.58 -min_count_ratio_skip 0.59 -max_len_kmer 13 -min_len_inter_kmer 7 -max_count_kmer 67	mutated	563	23	10	0	596
NextPolish	-min_map_quality 46 -max_ins_fold_sgs 12 -max_clip_ratio_sgs 0.12 -trim_len_edge 0 -ext_len_edge 11 -indel_balance_factor_sgs 0.25 -min_count_ratio_skip 0.52 -max_len_kmer 28 -min_len_inter_kmer 10 -max_count_kmer 72	random	563	23	10	0	596
NextPolish	-min_map_quality 46 -max_ins_fold_sgs 12 -max_clip_ratio_sgs 0.12 -trim_len_edge 0 -ext_len_edge 10 -indel_balance_factor_sgs 0.25 -min_count_ratio_skip 0.52 -max_len_kmer 28 -min_len_inter_kmer 10 -max_count_kmer 72	mutated	563	23	10	0	596
NextPolish	-min_map_quality 59 -max_ins_fold_sgs 8 -max_clip_ratio_sgs 0.03 -trim_len_edge 4 -ext_len_edge 0 -indel_balance_factor_sgs 0.19 -min_count_ratio_skip 0.78 -max_len_kmer 61 -min_len_inter_kmer 8 -max_count_kmer 28	random	896	68	23	0	987
NextPolish	-min_map_quality 22 -max_ins_fold_sgs 4 -max_clip_ratio_sgs 0.21 -trim_len_edge 0 -ext_len_edge 26 -indel_balance_factor_sgs 1.0 -min_count_ratio_skip 0.94 -max_len_kmer 96 -min_len_inter_kmer 10 -max_count_kmer 29	random	957	91	22	3	1073
NextPolish	-min_map_quality 46 -max_ins_fold_sgs 12 -max_clip_ratio_sgs 0.12 -trim_len_edge 0 -ext_len_edge 10 -indel_balance_factor_sgs 0.25 -min_count_ratio_skip 0.48 -max_len_kmer 28 -min_len_inter_kmer 10 -max_count_kmer 72	mutated	567	24	8	0	599
NextPolish	-min_map_quality 47 -max_ins_fold_sgs 9 -max_clip_ratio_sgs 0.02 -trim_len_edge 17 -ext_len_edge 1 -indel_balance_factor_sgs 0.72 -min_count_ratio_skip 0.82 -max_len_kmer 99 -min_len_inter_kmer 7 -max_count_kmer 60	random	918	84	18	4	1024
NextPolish	-min_map_quality 20 -max_ins_fold_sgs 9 -max_clip_ratio_sgs 0.91 -trim_len_edge 21 -ext_len_edge 10 -indel_balance_factor_sgs 0.08 -min_count_ratio_skip 0.98 -max_len_kmer 43 -min_len_inter_kmer 4 -max_count_kmer 71	random	889	80	23	4	996
NextPolish	-min_map_quality 46 -max_ins_fold_sgs 12 -max_clip_ratio_sgs 0.12 -trim_len_edge 0 -ext_len_edge 10 -indel_balance_factor_sgs 0.25 -min_count_ratio_skip 0.52 -max_len_kmer 36 -min_len_inter_kmer 10 -max_count_kmer 72	mutated	563	23	10	0	596
NextPolish	-min_map_quality 26 -max_ins_fold_sgs 9 -max_clip_ratio_sgs 0.02 -trim_len_edge 20 -ext_len_edge 0 -indel_balance_factor_sgs 0.21 -min_count_ratio_skip 0.77 -max_len_kmer 35 -min_len_inter_kmer 6 -max_count_kmer 75	random	888	76	22	4	990
NextPolish	-min_map_quality 46 -max_ins_fold_sgs 12 -max_clip_ratio_sgs 0.12 -trim_len_edge 0 -ext_len_edge 10 -indel_balance_factor_sgs 0.25 -min_count_ratio_skip 0.47 -max_len_kmer 36 -min_len_inter_kmer 10 -max_count_kmer 72	mutated	567	24	8	0	599
NextPolish	-min_map_quality 19 -max_ins_fold_sgs 13 -max_clip_ratio_sgs 0.4 -trim_len_edge 5 -ext_len_edge 2 -indel_balance_factor_sgs 0.63 -min_count_ratio_skip 0.97 -max_len_kmer 29 -min_len_inter_kmer 6 -max_count_kmer 65	random	941	86	22	3	1052
NextPolish	-min_map_quality 46 -max_ins_fold_sgs 12 -max_clip_ratio_sgs 0.03 -trim_len_edge 0 -ext_len_edge 10 -indel_balance_factor_sgs 0.25 -min_count_ratio_skip 0.52 -max_len_kmer 36 -min_len_inter_kmer 10 -max_count_kmer 82	mutated	563	23	10	0	596
NextPolish	-min_map_quality 31 -max_ins_fold_sgs 1 -max_clip_ratio_sgs 0.29 -trim_len_edge 1 -ext_len_edge 17 -indel_balance_factor_sgs 0.33 -min_count_ratio_skip 0.93 -max_len_kmer 10 -min_len_inter_kmer 1 -max_count_kmer 11	random	946	89	21	3	1059
NextPolish	-min_map_quality 28 -max_ins_fold_sgs 1 -max_clip_ratio_sgs 0.08 -trim_len_edge 4 -ext_len_edge 17 -indel_balance_factor_sgs 0.98 -min_count_ratio_skip 0.94 -max_len_kmer 53 -min_len_inter_kmer 1 -max_count_kmer 46	random	939	88	23	3	1053
NextPolish	-min_map_quality 42 -max_ins_fold_sgs 15 -max_clip_ratio_sgs 0.65 -trim_len_edge 0 -ext_len_edge 11 -indel_balance_factor_sgs 0.79 -min_count_ratio_skip 0.98 -max_len_kmer 51 -min_len_inter_kmer 7 -max_count_kmer 49	random	957	91	22	4	1074
NextPolish	-min_map_quality 46 -max_ins_fold_sgs 12 -max_clip_ratio_sgs 0.03 -trim_len_edge 0 -ext_len_edge 11 -indel_balance_factor_sgs 0.25 -min_count_ratio_skip 0.52 -max_len_kmer 45 -min_len_inter_kmer 10 -max_count_kmer 82	mutated	563	23	10	0	596
NextPolish	-min_map_quality 52 -max_ins_fold_sgs 9 -max_clip_ratio_sgs 0.48 -trim_len_edge 18 -ext_len_edge 25 -indel_balance_factor_sgs 0.2 -min_count_ratio_skip 0.81 -max_len_kmer 27 -min_len_inter_kmer 7 -max_count_kmer 53	random	910	80	21	5	1016
NextPolish	-min_map_quality 50 -max_ins_fold_sgs 12 -max_clip_ratio_sgs 0.03 -trim_len_edge 0 -ext_len_edge 11 -indel_balance_factor_sgs 0.25 -min_count_ratio_skip 0.52 -max_len_kmer 45 -min_len_inter_kmer 10 -max_count_kmer 82	mutated	563	23	10	0	596
NextPolish	-min_map_quality 48 -max_ins_fold_sgs 6 -max_clip_ratio_sgs 0.0 -trim_len_edge 3 -ext_len_edge 22 -indel_balance_factor_sgs 0.3 -min_count_ratio_skip 0.99 -max_len_kmer 86 -min_len_inter_kmer 3 -max_count_kmer 99	random	944	88	23	4	1059
NextPolish	-min_map_quality 50 -max_ins_fold_sgs 10 -max_clip_ratio_sgs 0.03 -trim_len_edge 0 -ext_len_edge 11 -indel_balance_factor_sgs 0.25 -min_count_ratio_skip 0.61 -max_len_kmer 45 -min_len_inter_kmer 10 -max_count_kmer 82	mutated	575	25	11	0	611
NextPolish	-min_map_quality 36 -max_ins_fold_sgs 15 -max_clip_ratio_sgs 0.0 -trim_len_edge 0 -ext_len_edge 5 -indel_balance_factor_sgs 0.11 -min_count_ratio_skip 0.78 -max_len_kmer 52 -min_len_inter_kmer 3 -max_count_kmer 76	random	862	62	16	0	940
NextPolish	-min_map_quality 50 -max_ins_fold_sgs 10 -max_clip_ratio_sgs 0.0 -trim_len_edge 0 -ext_len_edge 11 -indel_balance_factor_sgs 0.28 -min_count_ratio_skip 0.52 -max_len_kmer 45 -min_len_inter_kmer 10 -max_count_kmer 82	mutated	563	23	10	0	596
NextPolish	-min_map_quality 53 -max_ins_fold_sgs 15 -max_clip_ratio_sgs 0.0 -trim_len_edge 3 -ext_len_edge 0 -indel_balance_factor_sgs 0.01 -min_count_ratio_skip 0.66 -max_len_kmer 76 -min_len_inter_kmer 1 -max_count_kmer 56	random	640	30	16	0	686
NextPolish	-min_map_quality 18 -max_ins_fold_sgs 1 -max_clip_ratio_sgs 0.01 -trim_len_edge 5 -ext_len_edge 24 -indel_balance_factor_sgs 0.52 -min_count_ratio_skip 0.84 -max_len_kmer 20 -min_len_inter_kmer 10 -max_count_kmer 98	random	931	78	23	3	1035
NextPolish	-min_map_quality 47 -max_ins_fold_sgs 10 -max_clip_ratio_sgs 0.0 -trim_len_edge 0 -ext_len_edge 12 -indel_balance_factor_sgs 0.22 -min_count_ratio_skip 0.52 -max_len_kmer 45 -min_len_inter_kmer 10 -max_count_kmer 81	mutated	563	23	10	0	596
NextPolish	-min_map_quality 57 -max_ins_fold_sgs 2 -max_clip_ratio_sgs 0.0 -trim_len_edge 3 -ext_len_edge 3 -indel_balance_factor_sgs 0.48 -min_count_ratio_skip 0.9 -max_len_kmer 44 -min_len_inter_kmer 6 -max_count_kmer 32	random	944	86	23	3	1056
NextPolish	-min_map_quality 47 -max_ins_fold_sgs 10 -max_clip_ratio_sgs 0.0 -trim_len_edge 1 -ext_len_edge 12 -indel_balance_factor_sgs 0.22 -min_count_ratio_skip 0.52 -max_len_kmer 47 -min_len_inter_kmer 10 -max_count_kmer 81	mutated	583	22	12	0	617
NextPolish	-min_map_quality 7 -max_ins_fold_sgs 14 -max_clip_ratio_sgs 0.63 -trim_len_edge 20 -ext_len_edge 1 -indel_balance_factor_sgs 0.69 -min_count_ratio_skip 0.98 -max_len_kmer 68 -min_len_inter_kmer 1 -max_count_kmer 41	random	900	79	22	4	1005
NextPolish	-min_map_quality 47 -max_ins_fold_sgs 10 -max_clip_ratio_sgs 0.0 -trim_len_edge 0 -ext_len_edge 12 -indel_balance_factor_sgs 0.22 -min_count_ratio_skip 0.52 -max_len_kmer 43 -min_len_inter_kmer 10 -max_count_kmer 81	mutated	563	23	10	0	596
NextPolish	-min_map_quality 19 -max_ins_fold_sgs 5 -max_clip_ratio_sgs 0.18 -trim_len_edge 14 -ext_len_edge 0 -indel_balance_factor_sgs 0.1 -min_count_ratio_skip 0.82 -max_len_kmer 30 -min_len_inter_kmer 5 -max_count_kmer 40	random	897	85	20	3	1005
NextPolish	-min_map_quality 37 -max_ins_fold_sgs 2 -max_clip_ratio_sgs 0.66 -trim_len_edge 1 -ext_len_edge 1 -indel_balance_factor_sgs 0.82 -min_count_ratio_skip 0.3 -max_len_kmer 18 -min_len_inter_kmer 4 -max_count_kmer 62	random	586	23	9	0	618
NextPolish	-min_map_quality 47 -max_ins_fold_sgs 10 -max_clip_ratio_sgs 0.02 -trim_len_edge 0 -ext_len_edge 12 -indel_balance_factor_sgs 0.22 -min_count_ratio_skip 0.52 -max_len_kmer 42 -min_len_inter_kmer 10 -max_count_kmer 81	mutated	563	23	10	0	596
NextPolish	-min_map_quality 50 -max_ins_fold_sgs 1 -max_clip_ratio_sgs 0.22 -trim_len_edge 16 -ext_len_edge 6 -indel_balance_factor_sgs 0.77 -min_count_ratio_skip 0.48 -max_len_kmer 67 -min_len_inter_kmer 1 -max_count_kmer 50	random	1049	140	37	3	1229
NextPolish	-min_map_quality 47 -max_ins_fold_sgs 10 -max_clip_ratio_sgs 0.02 -trim_len_edge 0 -ext_len_edge 12 -indel_balance_factor_sgs 0.22 -min_count_ratio_skip 0.56 -max_len_kmer 42 -min_len_inter_kmer 12 -max_count_kmer 81	mutated	563	23	10	0	596
NextPolish	-min_map_quality 21 -max_ins_fold_sgs 13 -max_clip_ratio_sgs 0.97 -trim_len_edge 0 -ext_len_edge 20 -indel_balance_factor_sgs 0.75 -min_count_ratio_skip 0.92 -max_len_kmer 65 -min_len_inter_kmer 7 -max_count_kmer 31	random	957	91	22	3	1073
NextPolish	-min_map_quality 47 -max_ins_fold_sgs 10 -max_clip_ratio_sgs 0.02 -trim_len_edge 0 -ext_len_edge 13 -indel_balance_factor_sgs 0.22 -min_count_ratio_skip 0.6 -max_len_kmer 42 -min_len_inter_kmer 12 -max_count_kmer 81	mutated	563	23	10	0	596
NextPolish	-min_map_quality 45 -max_ins_fold_sgs 11 -max_clip_ratio_sgs 0.48 -trim_len_edge 1 -ext_len_edge 10 -indel_balance_factor_sgs 0.99 -min_count_ratio_skip 0.7 -max_len_kmer 77 -min_len_inter_kmer 5 -max_count_kmer 75	random	791	51	14	0	856
NextPolish	-min_map_quality 42 -max_ins_fold_sgs 6 -max_clip_ratio_sgs 0.46 -trim_len_edge 2 -ext_len_edge 16 -indel_balance_factor_sgs 0.05 -min_count_ratio_skip 0.96 -max_len_kmer 77 -min_len_inter_kmer 1 -max_count_kmer 60	random	945	89	21	4	1059
NextPolish	-min_map_quality 47 -max_ins_fold_sgs 10 -max_clip_ratio_sgs 0.02 -trim_len_edge 0 -ext_len_edge 13 -indel_balance_factor_sgs 0.22 -min_count_ratio_skip 0.6 -max_len_kmer 39 -min_len_inter_kmer 12 -max_count_kmer 81	mutated	563	23	10	0	596
NextPolish	-min_map_quality 31 -max_ins_fold_sgs 5 -max_clip_ratio_sgs 0.91 -trim_len_edge 0 -ext_len_edge 2 -indel_balance_factor_sgs 0.39 -min_count_ratio_skip 0.71 -max_len_kmer 86 -min_len_inter_kmer 7 -max_count_kmer 78	random	777	46	13	0	836
NextPolish	-min_map_quality 47 -max_ins_fold_sgs 9 -max_clip_ratio_sgs 0.02 -trim_len_edge 0 -ext_len_edge 13 -indel_balance_factor_sgs 0.22 -min_count_ratio_skip 0.6 -max_len_kmer 47 -min_len_inter_kmer 12 -max_count_kmer 81	mutated	563	23	10	0	596
NextPolish	-min_map_quality 21 -max_ins_fold_sgs 14 -max_clip_ratio_sgs 0.01 -trim_len_edge 4 -ext_len_edge 0 -indel_balance_factor_sgs 0.86 -min_count_ratio_skip 0.36 -max_len_kmer 58 -min_len_inter_kmer 3 -max_count_kmer 65	random	652	34	15	0	701
NextPolish	-min_map_quality 47 -max_ins_fold_sgs 9 -max_clip_ratio_sgs 0.02 -trim_len_edge 0 -ext_len_edge 12 -indel_balance_factor_sgs 0.22 -min_count_ratio_skip 0.6 -max_len_kmer 47 -min_len_inter_kmer 12 -max_count_kmer 81	mutated	563	23	10	0	596
NextPolish	-min_map_quality 5 -max_ins_fold_sgs 1 -max_clip_ratio_sgs 0.06 -trim_len_edge 0 -ext_len_edge 7 -indel_balance_factor_sgs 0.44 -min_count_ratio_skip 0.93 -max_len_kmer 36 -min_len_inter_kmer 9 -max_count_kmer 34	random	957	91	22	3	1073
NextPolish	-min_map_quality 47 -max_ins_fold_sgs 7 -max_clip_ratio_sgs 0.1 -trim_len_edge 0 -ext_len_edge 10 -indel_balance_factor_sgs 0.15 -min_count_ratio_skip 0.6 -max_len_kmer 47 -min_len_inter_kmer 12 -max_count_kmer 81	mutated	563	23	10	0	596
NextPolish	-min_map_quality 41 -max_ins_fold_sgs 15 -max_clip_ratio_sgs 0.86 -trim_len_edge 18 -ext_len_edge 0 -indel_balance_factor_sgs 0.73 -min_count_ratio_skip 0.4 -max_len_kmer 90 -min_len_inter_kmer 6 -max_count_kmer 71	random	1122	166	47	10	1345
NextPolish	-min_map_quality 45 -max_ins_fold_sgs 7 -max_clip_ratio_sgs 0.1 -trim_len_edge 1 -ext_len_edge 10 -indel_balance_factor_sgs 0.15 -min_count_ratio_skip 0.6 -max_len_kmer 48 -min_len_inter_kmer 12 -max_count_kmer 81	mutated	583	22	12	0	617
NextPolish	-min_map_quality 8 -max_ins_fold_sgs 3 -max_clip_ratio_sgs 0.58 -trim_len_edge 26 -ext_len_edge 0 -indel_balance_factor_sgs 0.43 -min_count_ratio_skip 0.82 -max_len_kmer 89 -min_len_inter_kmer 6 -max_count_kmer 32	random	914	84	23	4	1025
NextPolish	-min_map_quality 47 -max_ins_fold_sgs 7 -max_clip_ratio_sgs 0.1 -trim_len_edge 0 -ext_len_edge 8 -indel_balance_factor_sgs 0.09 -min_count_ratio_skip 0.6 -max_len_kmer 47 -min_len_inter_kmer 12 -max_count_kmer 82	mutated	563	23	10	0	596
NextPolish	-min_map_quality 15 -max_ins_fold_sgs 5 -max_clip_ratio_sgs 0.0 -trim_len_edge 3 -ext_len_edge 3 -indel_balance_factor_sgs 0.23 -min_count_ratio_skip 0.87 -max_len_kmer 10 -min_len_inter_kmer 10 -max_count_kmer 90	random	938	81	22	3	1044
NextPolish	-min_map_quality 30 -max_ins_fold_sgs 12 -max_clip_ratio_sgs 0.0 -trim_len_edge 9 -ext_len_edge 0 -indel_balance_factor_sgs 0.78 -min_count_ratio_skip 0.92 -max_len_kmer 70 -min_len_inter_kmer 10 -max_count_kmer 49	random	920	79	18	3	1020
NextPolish	-min_map_quality 47 -max_ins_fold_sgs 7 -max_clip_ratio_sgs 0.17 -trim_len_edge 0 -ext_len_edge 8 -indel_balance_factor_sgs 0.09 -min_count_ratio_skip 0.6 -max_len_kmer 47 -min_len_inter_kmer 12 -max_count_kmer 82	mutated	563	23	10	0	596
NextPolish	-min_map_quality 50 -max_ins_fold_sgs 12 -max_clip_ratio_sgs 0.91 -trim_len_edge 0 -ext_len_edge 3 -indel_balance_factor_sgs 0.17 -min_count_ratio_skip 0.78 -max_len_kmer 88 -min_len_inter_kmer 5 -max_count_kmer 90	random	862	62	16	0	940
NextPolish	-min_map_quality 47 -max_ins_fold_sgs 9 -max_clip_ratio_sgs 0.17 -trim_len_edge 0 -ext_len_edge 8 -indel_balance_factor_sgs 0.09 -min_count_ratio_skip 0.6 -max_len_kmer 47 -min_len_inter_kmer 12 -max_count_kmer 82	mutated	563	23	10	0	596
NextPolish	-min_map_quality 9 -max_ins_fold_sgs 5 -max_clip_ratio_sgs 0.81 -trim_len_edge 16 -ext_len_edge 0 -indel_balance_factor_sgs 0.22 -min_count_ratio_skip 0.86 -max_len_kmer 62 -min_len_inter_kmer 6 -max_count_kmer 41	random	924	85	18	3	1030
NextPolish	-min_map_quality 47 -max_ins_fold_sgs 9 -max_clip_ratio_sgs 0.17 -trim_len_edge 0 -ext_len_edge 7 -indel_balance_factor_sgs 0.09 -min_count_ratio_skip 0.6 -max_len_kmer 47 -min_len_inter_kmer 12 -max_count_kmer 82	mutated	563	23	10	0	596
NextPolish	-min_map_quality 60 -max_ins_fold_sgs 3 -max_clip_ratio_sgs 0.08 -trim_len_edge 11 -ext_len_edge 0 -indel_balance_factor_sgs 0.69 -min_count_ratio_skip 0.44 -max_len_kmer 33 -min_len_inter_kmer 10 -max_count_kmer 51	random	864	70	25	0	959
NextPolish	-min_map_quality 42 -max_ins_fold_sgs 3 -max_clip_ratio_sgs 0.44 -trim_len_edge 22 -ext_len_edge 20 -indel_balance_factor_sgs 0.45 -min_count_ratio_skip 0.76 -max_len_kmer 26 -min_len_inter_kmer 5 -max_count_kmer 44	random	884	82	22	4	992
NextPolish	-min_map_quality 47 -max_ins_fold_sgs 9 -max_clip_ratio_sgs 0.17 -trim_len_edge 0 -ext_len_edge 7 -indel_balance_factor_sgs 0.09 -min_count_ratio_skip 0.6 -max_len_kmer 47 -min_len_inter_kmer 12 -max_count_kmer 78	mutated	563	23	10	0	596
NextPolish	-min_map_quality 6 -max_ins_fold_sgs 2 -max_clip_ratio_sgs 0.32 -trim_len_edge 17 -ext_len_edge 12 -indel_balance_factor_sgs 0.6 -min_count_ratio_skip 0.95 -max_len_kmer 14 -min_len_inter_kmer 5 -max_count_kmer 29	random	923	86	18	5	1032
NextPolish	-min_map_quality 47 -max_ins_fold_sgs 9 -max_clip_ratio_sgs 0.17 -trim_len_edge 0 -ext_len_edge 7 -indel_balance_factor_sgs 0.09 -min_count_ratio_skip 0.6 -max_len_kmer 47 -min_len_inter_kmer 14 -max_count_kmer 78	mutated	563	23	10	0	596
NextPolish	-min_map_quality 40 -max_ins_fold_sgs 15 -max_clip_ratio_sgs 0.01 -trim_len_edge 0 -ext_len_edge 0 -indel_balance_factor_sgs 0.16 -min_count_ratio_skip 0.59 -max_len_kmer 14 -min_len_inter_kmer 9 -max_count_kmer 98	random	563	23	10	0	596
NextPolish	-min_map_quality 42 -max_ins_fold_sgs 15 -max_clip_ratio_sgs 0.01 -trim_len_edge 0 -ext_len_edge 0 -indel_balance_factor_sgs 0.16 -min_count_ratio_skip 0.59 -max_len_kmer 20 -min_len_inter_kmer 9 -max_count_kmer 98	mutated	563	23	10	0	596
NextPolish	-min_map_quality 43 -max_ins_fold_sgs 3 -max_clip_ratio_sgs 0.29 -trim_len_edge 0 -ext_len_edge 9 -indel_balance_factor_sgs 0.91 -min_count_ratio_skip 0.74 -max_len_kmer 76 -min_len_inter_kmer 8 -max_count_kmer 59	random	778	47	13	0	838
NextPolish	-min_map_quality 42 -max_ins_fold_sgs 15 -max_clip_ratio_sgs 0.0 -trim_len_edge 0 -ext_len_edge 0 -indel_balance_factor_sgs 0.16 -min_count_ratio_skip 0.59 -max_len_kmer 20 -min_len_inter_kmer 9 -max_count_kmer 98	mutated	563	23	10	0	596
NextPolish	-min_map_quality 29 -max_ins_fold_sgs 6 -max_clip_ratio_sgs 0.82 -trim_len_edge 25 -ext_len_edge 0 -indel_balance_factor_sgs 0.03 -min_count_ratio_skip 0.99 -max_len_kmer 66 -min_len_inter_kmer 3 -max_count_kmer 63	random	902	82	21	4	1009
NextPolish	-min_map_quality 14 -max_ins_fold_sgs 5 -max_clip_ratio_sgs 0.01 -trim_len_edge 1 -ext_len_edge 21 -indel_balance_factor_sgs 0.29 -min_count_ratio_skip 0.98 -max_len_kmer 54 -min_len_inter_kmer 9 -max_count_kmer 41	random	946	89	21	4	1060
NextPolish	-min_map_quality 42 -max_ins_fold_sgs 15 -max_clip_ratio_sgs 0.0 -trim_len_edge 0 -ext_len_edge 0 -indel_balance_factor_sgs 0.16 -min_count_ratio_skip 0.59 -max_len_kmer 19 -min_len_inter_kmer 9 -max_count_kmer 98	mutated	563	23	10	0	596
NextPolish	-min_map_quality 60 -max_ins_fold_sgs 4 -max_clip_ratio_sgs 0.03 -trim_len_edge 0 -ext_len_edge 11 -indel_balance_factor_sgs 0.36 -min_count_ratio_skip 0.81 -max_len_kmer 84 -min_len_inter_kmer 7 -max_count_kmer 87	random	909	72	17	0	998
NextPolish	-min_map_quality 7 -max_ins_fold_sgs 2 -max_clip_ratio_sgs 0.12 -trim_len_edge 0 -ext_len_edge 14 -indel_balance_factor_sgs 0.6 -min_count_ratio_skip 0.34 -max_len_kmer 36 -min_len_inter_kmer 6 -max_count_kmer 60	random	569	24	8	0	601
NextPolish	-min_map_quality 42 -max_ins_fold_sgs 15 -max_clip_ratio_sgs 0.0 -trim_len_edge 0 -ext_len_edge 0 -indel_balance_factor_sgs 0.21 -min_count_ratio_skip 0.59 -max_len_kmer 19 -min_len_inter_kmer 9 -max_count_kmer 98	mutated	563	23	10	0	596
NextPolish	-min_map_quality 35 -max_ins_fold_sgs 7 -max_clip_ratio_sgs 0.0 -trim_len_edge 0 -ext_len_edge 7 -indel_balance_factor_sgs 0.7 -min_count_ratio_skip 0.89 -max_len_kmer 98 -min_len_inter_kmer 1 -max_count_kmer 68	random	957	86	22	3	1068
NextPolish	-min_map_quality 42 -max_ins_fold_sgs 15 -max_clip_ratio_sgs 0.0 -trim_len_edge 0 -ext_len_edge 0 -indel_balance_factor_sgs 0.14 -min_count_ratio_skip 0.59 -max_len_kmer 19 -min_len_inter_kmer 9 -max_count_kmer 98	mutated	563	23	10	0	596
NextPolish	-min_map_quality 28 -max_ins_fold_sgs 14 -max_clip_ratio_sgs 0.0 -trim_len_edge 26 -ext_len_edge 0 -indel_balance_factor_sgs 0.83 -min_count_ratio_skip 0.46 -max_len_kmer 55 -min_len_inter_kmer 7 -max_count_kmer 4	random	1438	294	91	29	1852
NextPolish	-min_map_quality 42 -max_ins_fold_sgs 15 -max_clip_ratio_sgs 0.0 -trim_len_edge 0 -ext_len_edge 0 -indel_balance_factor_sgs 0.14 -min_count_ratio_skip 0.59 -max_len_kmer 19 -min_len_inter_kmer 9 -max_count_kmer 96	mutated	563	23	10	0	596
NextPolish	-min_map_quality 18 -max_ins_fold_sgs 10 -max_clip_ratio_sgs 0.54 -trim_len_edge 26 -ext_len_edge 0 -indel_balance_factor_sgs 0.1 -min_count_ratio_skip 0.1 -max_len_kmer 41 -min_len_inter_kmer 1 -max_count_kmer 47	random	1516	343	102	34	1995
NextPolish	-min_map_quality 27 -max_ins_fold_sgs 1 -max_clip_ratio_sgs 0.04 -trim_len_edge 2 -ext_len_edge 7 -indel_balance_factor_sgs 0.81 -min_count_ratio_skip 0.44 -max_len_kmer 55 -min_len_inter_kmer 2 -max_count_kmer 57	random	603	25	11	0	639
NextPolish	-min_map_quality 42 -max_ins_fold_sgs 13 -max_clip_ratio_sgs 0.0 -trim_len_edge 0 -ext_len_edge 0 -indel_balance_factor_sgs 0.14 -min_count_ratio_skip 0.63 -max_len_kmer 19 -min_len_inter_kmer 9 -max_count_kmer 96	mutated	575	25	11	0	611
NextPolish	-min_map_quality 17 -max_ins_fold_sgs 3 -max_clip_ratio_sgs 0.01 -trim_len_edge 0 -ext_len_edge 7 -indel_balance_factor_sgs 0.64 -min_count_ratio_skip 0.97 -max_len_kmer 30 -min_len_inter_kmer 8 -max_count_kmer 85	random	957	91	22	4	1074
NextPolish	-min_map_quality 42 -max_ins_fold_sgs 15 -max_clip_ratio_sgs 0.0 -trim_len_edge 1 -ext_len_edge 0 -indel_balance_factor_sgs 0.14 -min_count_ratio_skip 0.59 -max_len_kmer 19 -min_len_inter_kmer 9 -max_count_kmer 90	mutated	583	22	12	0	617
NextPolish	-min_map_quality 26 -max_ins_fold_sgs 11 -max_clip_ratio_sgs 0.21 -trim_len_edge 0 -ext_len_edge 0 -indel_balance_factor_sgs 0.28 -min_count_ratio_skip 0.53 -max_len_kmer 58 -min_len_inter_kmer 2 -max_count_kmer 79	random	563	23	10	0	596
NextPolish	-min_map_quality 35 -max_ins_fold_sgs 4 -max_clip_ratio_sgs 0.04 -trim_len_edge 14 -ext_len_edge 0 -indel_balance_factor_sgs 0.59 -min_count_ratio_skip 0.93 -max_len_kmer 36 -min_len_inter_kmer 7 -max_count_kmer 82	random	903	87	20	3	1013
NextPolish	-min_map_quality 26 -max_ins_fold_sgs 11 -max_clip_ratio_sgs 0.19 -trim_len_edge 0 -ext_len_edge 0 -indel_balance_factor_sgs 0.28 -min_count_ratio_skip 0.53 -max_len_kmer 58 -min_len_inter_kmer 2 -max_count_kmer 79	mutated	563	23	10	0	596
NextPolish	-min_map_quality 30 -max_ins_fold_sgs 8 -max_clip_ratio_sgs 0.25 -trim_len_edge 0 -ext_len_edge 0 -indel_balance_factor_sgs 0.42 -min_count_ratio_skip 0.82 -max_len_kmer 65 -min_len_inter_kmer 4 -max_count_kmer 13	random	909	72	17	0	998
NextPolish	-min_map_quality 26 -max_ins_fold_sgs 11 -max_clip_ratio_sgs 0.19 -trim_len_edge 0 -ext_len_edge 0 -indel_balance_factor_sgs 0.28 -min_count_ratio_skip 0.53 -max_len_kmer 68 -min_len_inter_kmer 2 -max_count_kmer 79	mutated	563	23	10	0	596
NextPolish	-min_map_quality 56 -max_ins_fold_sgs 11 -max_clip_ratio_sgs 0.64 -trim_len_edge 2 -ext_len_edge 0 -indel_balance_factor_sgs 1.0 -min_count_ratio_skip 0.99 -max_len_kmer 32 -min_len_inter_kmer 2 -max_count_kmer 79	random	945	89	21	4	1059
NextPolish	-min_map_quality 59 -max_ins_fold_sgs 10 -max_clip_ratio_sgs 0.94 -trim_len_edge 2 -ext_len_edge 22 -indel_balance_factor_sgs 0.64 -min_count_ratio_skip 0.67 -max_len_kmer 15 -min_len_inter_kmer 7 -max_count_kmer 34	random	814	53	15	0	882
NextPolish	-min_map_quality 26 -max_ins_fold_sgs 11 -max_clip_ratio_sgs 0.19 -trim_len_edge 0 -ext_len_edge 0 -indel_balance_factor_sgs 0.28 -min_count_ratio_skip 0.63 -max_len_kmer 68 -min_len_inter_kmer 2 -max_count_kmer 79	mutated	575	25	11	0	611
NextPolish	-min_map_quality 49 -max_ins_fold_sgs 10 -max_clip_ratio_sgs 0.01 -trim_len_edge 12 -ext_len_edge 19 -indel_balance_factor_sgs 0.49 -min_count_ratio_skip 1.0 -max_len_kmer 95 -min_len_inter_kmer 5 -max_count_kmer 7	random	904	82	20	3	1009
NextPolish	-min_map_quality 26 -max_ins_fold_sgs 11 -max_clip_ratio_sgs 0.21 -trim_len_edge 0 -ext_len_edge 1 -indel_balance_factor_sgs 0.33 -min_count_ratio_skip 0.45 -max_len_kmer 68 -min_len_inter_kmer 2 -max_count_kmer 79	mutated	567	24	8	0	599
NextPolish	-min_map_quality 8 -max_ins_fold_sgs 1 -max_clip_ratio_sgs 0.23 -trim_len_edge 2 -ext_len_edge 1 -indel_balance_factor_sgs 0.07 -min_count_ratio_skip 0.48 -max_len_kmer 64 -min_len_inter_kmer 5 -max_count_kmer 99	random	603	25	11	0	639
NextPolish	-min_map_quality 26 -max_ins_fold_sgs 11 -max_clip_ratio_sgs 0.19 -trim_len_edge 0 -ext_len_edge 0 -indel_balance_factor_sgs 0.23 -min_count_ratio_skip 0.53 -max_len_kmer 68 -min_len_inter_kmer 2 -max_count_kmer 79	mutated	563	23	10	0	596
NextPolish	-min_map_quality 44 -max_ins_fold_sgs 2 -max_clip_ratio_sgs 0.11 -trim_len_edge 20 -ext_len_edge 18 -indel_balance_factor_sgs 0.31 -min_count_ratio_skip 0.84 -max_len_kmer 63 -min_len_inter_kmer 6 -max_count_kmer 75	random	900	79	22	4	1005
NextPolish	-min_map_quality 26 -max_ins_fold_sgs 11 -max_clip_ratio_sgs 0.19 -trim_len_edge 0 -ext_len_edge 0 -indel_balance_factor_sgs 0.23 -min_count_ratio_skip 0.53 -max_len_kmer 68 -min_len_inter_kmer 2 -max_count_kmer 76	mutated	563	23	10	0	596
NextPolish	-min_map_quality 1 -max_ins_fold_sgs 3 -max_clip_ratio_sgs 0.63 -trim_len_edge 8 -ext_len_edge 23 -indel_balance_factor_sgs 0.27 -min_count_ratio_skip 0.85 -max_len_kmer 56 -min_len_inter_kmer 8 -max_count_kmer 74	random	913	80	19	3	1015
NextPolish	-min_map_quality 26 -max_ins_fold_sgs 11 -max_clip_ratio_sgs 0.19 -trim_len_edge 0 -ext_len_edge 1 -indel_balance_factor_sgs 0.23 -min_count_ratio_skip 0.53 -max_len_kmer 68 -min_len_inter_kmer 2 -max_count_kmer 76	mutated	563	23	10	0	596
NextPolish	-min_map_quality 29 -max_ins_fold_sgs 14 -max_clip_ratio_sgs 0.0 -trim_len_edge 14 -ext_len_edge 5 -indel_balance_factor_sgs 0.43 -min_count_ratio_skip 0.69 -max_len_kmer 78 -min_len_inter_kmer 7 -max_count_kmer 70	random	854	73	19	0	946
NextPolish	-min_map_quality 26 -max_ins_fold_sgs 11 -max_clip_ratio_sgs 0.19 -trim_len_edge 0 -ext_len_edge 1 -indel_balance_factor_sgs 0.23 -min_count_ratio_skip 0.53 -max_len_kmer 68 -min_len_inter_kmer 3 -max_count_kmer 76	mutated	563	23	10	0	596
NextPolish	-min_map_quality 56 -max_ins_fold_sgs 5 -max_clip_ratio_sgs 0.86 -trim_len_edge 0 -ext_len_edge 13 -indel_balance_factor_sgs 0.52 -min_count_ratio_skip 0.8 -max_len_kmer 70 -min_len_inter_kmer 5 -max_count_kmer 10	random	862	62	16	0	940
NextPolish	-min_map_quality 26 -max_ins_fold_sgs 10 -max_clip_ratio_sgs 0.2 -trim_len_edge 0 -ext_len_edge 1 -indel_balance_factor_sgs 0.23 -min_count_ratio_skip 0.53 -max_len_kmer 68 -min_len_inter_kmer 3 -max_count_kmer 76	mutated	563	23	10	0	596
NextPolish	-min_map_quality 9 -max_ins_fold_sgs 4 -max_clip_ratio_sgs 0.21 -trim_len_edge 20 -ext_len_edge 2 -indel_balance_factor_sgs 0.84 -min_count_ratio_skip 0.21 -max_len_kmer 21 -min_len_inter_kmer 9 -max_count_kmer 92	random	1265	209	60	16	1550
NextPolish	-min_map_quality 26 -max_ins_fold_sgs 12 -max_clip_ratio_sgs 0.2 -trim_len_edge 0 -ext_len_edge 1 -indel_balance_factor_sgs 0.23 -min_count_ratio_skip 0.53 -max_len_kmer 68 -min_len_inter_kmer 5 -max_count_kmer 76	mutated	563	23	10	0	596
NextPolish	-min_map_quality 23 -max_ins_fold_sgs 3 -max_clip_ratio_sgs 0.0 -trim_len_edge 0 -ext_len_edge 19 -indel_balance_factor_sgs 0.94 -min_count_ratio_skip 0.85 -max_len_kmer 84 -min_len_inter_kmer 9 -max_count_kmer 44	random	936	78	20	3	1037
NextPolish	-min_map_quality 50 -max_ins_fold_sgs 2 -max_clip_ratio_sgs 0.07 -trim_len_edge 1 -ext_len_edge 6 -indel_balance_factor_sgs 0.62 -min_count_ratio_skip 0.91 -max_len_kmer 62 -min_len_inter_kmer 6 -max_count_kmer 84	random	946	86	21	3	1056
NextPolish	-min_map_quality 21 -max_ins_fold_sgs 6 -max_clip_ratio_sgs 0.0 -trim_len_edge 0 -ext_len_edge 17 -indel_balance_factor_sgs 0.18 -min_count_ratio_skip 0.97 -max_len_kmer 31 -min_len_inter_kmer 3 -max_count_kmer 88	random	957	91	22	4	1074
NextPolish	-min_map_quality 26 -max_ins_fold_sgs 12 -max_clip_ratio_sgs 0.2 -trim_len_edge 2 -ext_len_edge 1 -indel_balance_factor_sgs 0.23 -min_count_ratio_skip 0.53 -max_len_kmer 68 -min_len_inter_kmer 5 -max_count_kmer 67	mutated	601	25	13	0	639
NextPolish	-min_map_quality 21 -max_ins_fold_sgs 7 -max_clip_ratio_sgs 0.1 -trim_len_edge 0 -ext_len_edge 1 -indel_balance_factor_sgs 0.14 -min_count_ratio_skip 0.48 -max_len_kmer 63 -min_len_inter_kmer 2 -max_count_kmer 21	random	567	24	8	0	599
NextPolish	-min_map_quality 22 -max_ins_fold_sgs 12 -max_clip_ratio_sgs 0.14 -trim_len_edge 0 -ext_len_edge 1 -indel_balance_factor_sgs 0.23 -min_count_ratio_skip 0.53 -max_len_kmer 68 -min_len_inter_kmer 5 -max_count_kmer 76	mutated	563	23	10	0	596
NextPolish	-min_map_quality 52 -max_ins_fold_sgs 13 -max_clip_ratio_sgs 0.16 -trim_len_edge 6 -ext_len_edge 0 -indel_balance_factor_sgs 0.95 -min_count_ratio_skip 0.51 -max_len_kmer 67 -min_len_inter_kmer 6 -max_count_kmer 29	random	675	36	16	0	727
NextPolish	-min_map_quality 22 -max_ins_fold_sgs 10 -max_clip_ratio_sgs 0.14 -trim_len_edge 0 -ext_len_edge 1 -indel_balance_factor_sgs 0.23 -min_count_ratio_skip 0.53 -max_len_kmer 68 -min_len_inter_kmer 5 -max_count_kmer 86	mutated	563	23	10	0	596
NextPolish	-min_map_quality 54 -max_ins_fold_sgs 9 -max_clip_ratio_sgs 0.17 -trim_len_edge 11 -ext_len_edge 7 -indel_balance_factor_sgs 0.67 -min_count_ratio_skip 0.92 -max_len_kmer 20 -min_len_inter_kmer 7 -max_count_kmer 95	random	913	76	20	3	1012
NextPolish	-min_map_quality 22 -max_ins_fold_sgs 8 -max_clip_ratio_sgs 0.14 -trim_len_edge 0 -ext_len_edge 1 -indel_balance_factor_sgs 0.23 -min_count_ratio_skip 0.53 -max_len_kmer 68 -min_len_inter_kmer 5 -max_count_kmer 86	mutated	563	23	10	0	596
NextPolish	-min_map_quality 14 -max_ins_fold_sgs 7 -max_clip_ratio_sgs 0.21 -trim_len_edge 25 -ext_len_edge 0 -indel_balance_factor_sgs 0.41 -min_count_ratio_skip 0.84 -max_len_kmer 49 -min_len_inter_kmer 8 -max_count_kmer 45	random	902	82	21	4	1009
NextPolish	-min_map_quality 22 -max_ins_fold_sgs 10 -max_clip_ratio_sgs 0.14 -trim_len_edge 0 -ext_len_edge 1 -indel_balance_factor_sgs 0.19 -min_count_ratio_skip 0.53 -max_len_kmer 68 -min_len_inter_kmer 5 -max_count_kmer 86	mutated	563	23	10	0	596
NextPolish	-min_map_quality 25 -max_ins_fold_sgs 3 -max_clip_ratio_sgs 0.0 -trim_len_edge 10 -ext_len_edge 8 -indel_balance_factor_sgs 0.81 -min_count_ratio_skip 0.91 -max_len_kmer 33 -min_len_inter_kmer 10 -max_count_kmer 27	random	917	80	19	3	1019
NextPolish	-min_map_quality 22 -max_ins_fold_sgs 10 -max_clip_ratio_sgs 0.14 -trim_len_edge 0 -ext_len_edge 1 -indel_balance_factor_sgs 0.12 -min_count_ratio_skip 0.53 -max_len_kmer 68 -min_len_inter_kmer 5 -max_count_kmer 86	mutated	563	23	10	0	596
NextPolish	-min_map_quality 49 -max_ins_fold_sgs 13 -max_clip_ratio_sgs 0.0 -trim_len_edge 4 -ext_len_edge 0 -indel_balance_factor_sgs 0.59 -min_count_ratio_skip 0.73 -max_len_kmer 98 -min_len_inter_kmer 3 -max_count_kmer 69	random	843	58	18	0	919
Pilon	--fix all --flank 10 --K 47 --mindepth 0.1 --minmq 0 --minqual 0	defaults	154	272	5	347	778
Pilon	--fix bases --flank 10 --K 47 --mindepth 0.1 --minmq 0 --minqual 0	bases	16	9	5	0	30
Pilon	--fix bases --flank 13 --K 81 --mindepth 0.18 --minmq 55 --minqual 36	random	18	18	17	17	70
Pilon	--fix bases --flank 10 --K 49 --mindepth 0.11 --minmq 0 --minqual 0	mutated	16	9	5	0	30
Pilon	--fix bases --flank 13 --K 83 --mindepth 4 --minmq 25 --minqual 26 --nostrays	random	16	8	3	1	28
Pilon	--fix bases --flank 13 --K 83 --mindepth 3 --minmq 25 --minqual 26	mutated	13	8	3	1	25
Pilon	--fix all --flank 0 --K 15 --mindepth 13 --minmq 45 --minqual 9	random	1143	2418	10	653	4224
Pilon	--fix bases --flank 13 --K 81 --mindepth 3 --minmq 25 --minqual 26	mutated	13	8	3	1	25
Pilon	--fix bases --flank 13 --K 13 --mindepth 3 --minmq 0 --minqual 33	random	13	8	3	0	24
Pilon	--fix bases --flank 11 --K 15 --mindepth 3 --minmq 0 --minqual 33	mutated	12	8	3	0	23
Pilon	--fix all --flank 4 --K 73 --mindepth 0.34 --minmq 42 --minqual 30	random	14	8	3	1	26
Pilon	--fix all --flank 11 --K 15 --mindepth 3 --minmq 0 --minqual 35	mutated	17	18	17	17	69
Pilon	--fix all --flank 10 --K 19 --mindepth 0.45 --minmq 58 --minqual 16 --nostrays	random	15	1823	153	914	2905
Pilon	--fix bases --flank 11 --K 15 --mindepth 3 --minmq 0 --minqual 29	mutated	12	8	3	0	23
Pilon	--fix bases --flank 4 --K 93 --mindepth 0.43 --minmq 28 --minqual 14 --nostrays	random	14	8	3	4	29
Pilon	--fix bases --flank 1 --K 85 --mindepth 0.89 --minmq 55 --minqual 22 --nostrays	random	14	10	11	11	46
Pilon	--fix bases --flank 11 --K 15 --mindepth 3 --minmq 1 --minqual 29	mutated	12	7	3	0	22
Pilon	--fix bases --flank 6 --K 55 --mindepth 0.61 --minmq 13 --minqual 39 --nostrays	random	17	18	18	17	70
Pilon	--fix bases --flank 11 --K 17 --mindepth 3 --minmq 2 --minqual 29	mutated	12	7	3	0	22
Pilon	--fix all --flank 14 --K 83 --mindepth 3 --minmq 24 --minqual 31 --nostrays	random	13	8	3	0	24
Pilon	--fix bases --flank 14 --K 19 --mindepth 3 --minmq 7 --minqual 29	mutated	13	8	3	0	24
Pilon	--fix all --flank 4 --K 11 --mindepth 0.14 --minmq 33 --minqual 13 --nostrays	random	56328	56155	10827	1703	125013
Pilon	--fix bases --flank 11 --K 15 --mindepth 3 --minmq 2 --minqual 29	mutated	12	7	3	0	22
Pilon	--fix bases --flank 1 --K 45 --mindepth 8 --minmq 12 --minqual 13	random	17	10	4	2	33
Pilon	--fix bases --flank 11 --K 13 --mindepth 3 --minmq 11 --minqual 29	mutated	12	7	3	0	22
Pilon	--fix bases --flank 7 --K 79 --mindepth 0.94 --minmq 57 --minqual 9	random	14	12	10	11	47
Pilon	--fix bases --flank 11 --K 13 --mindepth 3 --minmq 11 --minqual 34	mutated	12	7	3	0	22
Pilon	--fix all --flank 8 --K 19 --mindepth 0.79 --minmq 22 --minqual 12 --nostrays	random	14	159	732	573	1478
Pilon	--fix bases --flank 11 --K 13 --mindepth 3 --minmq 4 --minqual 38	mutated	17	18	17	17	69
Pilon	--fix all --flank 1 --K 89 --mindepth 0.39 --minmq 50 --minqual 10	random	14	8	3	139	164
Pilon	--fix bases --flank 9 --K 13 --mindepth 3 --minmq 3 --minqual 33	mutated	12	7	3	0	22
Pilon	--fix bases --flank 14 --K 55 --mindepth 24 --minmq 15 --minqual 36 --nostrays	random	18	18	18	18	72
Pilon	--fix all --flank 11 --K 91 --mindepth 11 --minmq 31 --minqual 12	random	18	14	10	8	50
Pilon	--fix bases --flank 9 --K 13 --mindepth 3 --minmq 2 --minqual 33	mutated	12	7	3	0	22
Pilon	--fix all --flank 11 --K 11 --mindepth 12 --minmq 15 --minqual 15 --nostrays	random	4035	101746	13369	1035	120185
Pilon	--fix bases --flank 8 --K 13 --mindepth 3 --minmq 5 --minqual 33	mutated	12	7	3	0	22
Pilon	--fix bases --flank 6 --K 13 --mindepth 10 --minmq 48 --minqual 4	random	17	13	9	3	42
Pilon	--fix bases --flank 8 --K 13 --mindepth 4 --minmq 5 --minqual 33	mutated	14	8	3	0	25
Pilon	--fix bases --flank 19 --K 15 --mindepth 0.03 --minmq 11 --minqual 25	random	16	10	3	2	31
Pilon	--fix bases --flank 10 --K 13 --mindepth 2 --minmq 5 --minqual 32	mutated	13	6	3	0	22
Pilon	--fix all --flank 16 --K 31 --mindepth 2 --minmq 10 --minqual 19 --nostrays	random	15	1821	350	0	2186
Pilon	--fix bases --flank 10 --K 13 --mindepth 2 --minmq 5 --minqual 33	mutated	13	6	3	0	22
Pilon	--fix bases --flank 19 --K 25 --mindepth 7 --minmq 8 --minqual 3	random	17	11	6	4	38
Pilon	--fix bases --flank 10 --K 13 --mindepth 2 --minmq 5 --minqual 36	mutated	17	18	17	17	69
Pilon	--fix bases --flank 3 --K 13 --mindepth 10 --minmq 21 --minqual 30	random	17	14	10	5	46
Pilon	--fix all --flank 5 --K 25 --mindepth 0.44 --minmq 33 --minqual 32	random	14	8	4	142	168
Pilon	--fix bases --flank 1 --K 51 --mindepth 0.01 --minmq 43 --minqual 16 --nostrays	random	14	8	3	0	25
Pilon	--fix bases --flank 10 --K 13 --mindepth 1 --minmq 5 --minqual 33	mutated	46	15	7	0	68
Pilon	--fix bases --flank 16 --K 95 --mindepth 5 --minmq 41 --minqual 34	random	16	10	4	3	33
Pilon	--fix bases --flank 10 --K 15 --mindepth 2 --minmq 10 --minqual 33	mutated	13	6	3	0	22
Pilon	--fix all --flank 11 --K 17 --mindepth 0.85 --minmq 46 --minqual 12	random	15	160	733	574	1482
Pilon	--fix all --flank 9 --K 15 --mindepth 2 --minmq 10 --minqual 36	mutated	17	18	17	17	69
Pilon	--fix bases --flank 18 --K 83 --mindepth 8 --minmq 24 --minqual 34 --nostrays	random	18	15	11	5	49
Pilon	--fix bases --flank 10 --K 15 --mindepth 3 --minmq 10 --minqual 33	mutated	12	7	3	0	22
Pilon	--fix bases --flank 11 --K 61 --mindepth 0.25 --minmq 52 --minqual 31	random	15	8	3	2	28
Pilon	--fix all --flank 18 --K 87 --mindepth 0.98 --minmq 57 --minqual 29 --nostrays	random	16	14	13	15	58
Pilon	--fix all --flank 10 --K 15 --mindepth 4 --minmq 10 --minqual 33	mutated	14	5832	4055	4609	14510
Pilon	--fix all --flank 3 --K 57 --mindepth 0.7 --minmq 6 --minqual 18	random	14	8	8	147	177
Pilon	--fix bases --flank 10 --K 95 --mindepth 5 --minmq 54 --minqual 13	random	15	8	3	1	27
Pilon	--fix bases --flank 11 --K 15 --mindepth 2 --minmq 12 --minqual 33	mutated	12	6	3	0	21
Pilon	--fix all --flank 18 --K 83 --mindepth 0.56 --minmq 24 --minqual 37	random	18	18	17	17	70
Pilon	--fix bases --flank 6 --K 73 --mindepth 0.87 --minmq 60 --minqual 3 --nostrays	random	14	11	10	10	45
Pilon	--fix bases --flank 11 --K 17 --mindepth 1 --minmq 12 --minqual 33	mutated	47	15	7	0	69
Pilon	--fix all --flank 15 --K 19 --mindepth 18 --minmq 45 --minqual 15 --nostrays	random	18	1833	165	926	2942
Pilon	--fix all --flank 3 --K 47 --mindepth 14 --minmq 44 --minqual 28 --nostrays	random	18	17	13	11	59
Pilon	--fix bases --flank 8 --K 17 --mindepth 2 --minmq 12 --minqual 33	mutated	13	6	3	0	22
Pilon	--fix all --flank 17 --K 99 --mindepth 4 --minmq 29 --minqual 5 --nostrays	random	16	10	3	0	29
Pilon	--fix bases --flank 11 --K 15 --mindepth 2 --minmq 19 --minqual 33	mutated	12	6	3	0	21
Pilon	--fix bases --flank 14 --K 97 --mindepth 0.49 --minmq 4 --minqual 29 --nostrays	random	16	10	4	4	34
Pilon	--fix bases --flank 4 --K 13 --mindepth 24 --minmq 14 --minqual 25	random	18	18	18	17	71
Pilon	--fix bases --flank 8 --K 15 --mindepth 2 --minmq 19 --minqual 33	mutated	13	6	3	0	22
Pilon	--fix all --flank 16 --K 89 --mindepth 1 --minmq 45 --minqual 14 --nostrays	random	99	22	7	0	128
Pilon	--fix bases --flank 13 --K 61 --mindepth 12 --minmq 50 --minqual 27 --nostrays	random	18	17	13	10	58
Pilon	--fix all --flank 18 --K 65 --mindepth 2 --minmq 20 --minqual 6	random	35	7	3	0	45
Pilon	--fix bases --flank 11 --K 17 --mindepth 2 --minmq 19 --minqual 33	mutated	12	6	3	0	21
Pilon	--fix bases --flank 18 --K 75 --mindepth 2 --minmq 7 --minqual 23 --nostrays	random	15	6	3	0	24
Pilon	--fix bases --flank 9 --K 17 --mindepth 2 --minmq 19 --minqual 35	mutated	17	18	17	17	69
Pilon	--fix bases --flank 14 --K 89 --mindepth 23 --minmq 7 --minqual 28	random	18	18	18	18	72
Pilon	--fix bases --flank 11 --K 17 --mindepth 1 --minmq 19 --minqual 33	mutated	47	15	7	0	69
Pilon	--fix bases --flank 16 --K 67 --mindepth 0.41 --minmq 48 --minqual 34 --nostrays	random	16	10	4	4	34
Pilon	--fix all --flank 5 --K 89 --mindepth 0.58 --minmq 25 --minqual 10 --nostrays	random	14	8	5	3	30
Pilon	--fix all --flank 11 --K 17 --mindepth 2 --minmq 19 --minqual 33	mutated	12	6	2357	1878	4253
Pilon	--fix bases --flank 4 --K 69 --mindepth 13 --minmq 31 --minqual 4 --nostrays	random	18	16	10	9	53
Pilon	--fix bases --flank 12 --K 15 --mindepth 2 --minmq 19 --minqual 33	mutated	14	6	3	0	23
Pilon	--fix all --flank 17 --K 29 --mindepth 0.68 --minmq 44 --minqual 15 --nostrays	random	16	1825	353	5	2199
Pilon	--fix bases --flank 15 --K 31 --mindepth 19 --minmq 31 --minqual 33	random	18	18	15	18	69
Pilon	--fix all --flank 11 --K 17 --mindepth 1 --minmq 19 --minqual 33	mutated	47	15	2361	1878	4301
Pilon	--fix bases --flank 2 --K 31 --mindepth 0.68 --minmq 6 --minqual 13 --nostrays	random	14	8	8	9	39
Pilon	--fix bases --flank 9 --K 17 --mindepth 2 --minmq 19 --minqual 33	mutated	13	6	3	0	22
Pilon	--fix all --flank 2 --K 83 --mindepth 12 --minmq 50 --minqual 7	random	17	15	10	146	188
Pilon	--fix all --flank 11 --K 19 --mindepth 2 --minmq 19 --minqual 37	mutated	17	18	17	17	69
Pilon	--fix all --flank 2 --K 31 --mindepth 10 --minmq 30 --minqual 33	random	17	14	9	143	183
Pilon	--fix bases --flank 14 --K 19 --mindepth 2 --minmq 25 --minqual 38	mutated	18	18	17	17	70
Pilon	--fix all --flank 13 --K 33 --mindepth 0.55 --minmq 18 --minqual 3 --nostrays	random	16	9	3	350	378
Pilon	--fix bases --flank 13 --K 19 --mindepth 2 --minmq 19 --minqual 33	mutated	14	6	3	0	23
Pilon	--fix all --flank 10 --K 57 --mindepth 0.07 --minmq 10 --minqual 23 --nostrays	random	15	8	3	139	165
Pilon	--fix bases --flank 11 --K 17 --mindepth 2 --minmq 26 --minqual 33	mutated	12	6	3	0	21
Pilon	--fix bases --flank 12 --K 21 --mindepth 19 --minmq 11 --minqual 37 --nostrays	random	18	18	18	18	72
Pilon	--fix all --flank 11 --K 15 --mindepth 3 --minmq 26 --minqual 33	mutated	12	17042	5979	4235	27268
Pilon	--fix all --flank 17 --K 37 --mindepth 19 --minmq 45 --minqual 26	random	18	1833	363	155	2369
Pilon	--fix bases --flank 11 --K 17 --mindepth 3 --minmq 22 --minqual 33	mutated	12	7	3	0	22
Pilon	--fix bases --flank 19 --K 43 --mindepth 9 --minmq 16 --minqual 21	random	18	14	13	5	50
Pilon	--fix bases --flank 9 --K 53 --mindepth 0.79 --minmq 50 --minqual 30	random	15	10	10	10	45
Pilon	--fix all --flank 9 --K 25 --mindepth 0.2 --minmq 7 --minqual 13 --nostrays	random	15	1823	350	348	2536
Pilon	--fix bases --flank 13 --K 19 --mindepth 1 --minmq 27 --minqual 31	random	51	13	7	0	71
Pilon	--fix bases --flank 11 --K 17 --mindepth 1 --minmq 26 --minqual 33	mutated	47	15	7	0	69
Pilon	--fix bases --flank 10 --K 77 --mindepth 0.28 --minmq 28 --minqual 6	random	15	8	3	0	26
Pilon	--fix bases --flank 12 --K 17 --mindepth 2 --minmq 26 --minqual 30	mutated	14	6	3	0	23
Pilon	--fix all --flank 14 --K 27 --mindepth 0.48 --minmq 44 --minqual 35	random	18	18	17	17	70
Pilon	--fix bases --flank 5 --K 85 --mindepth 6 --minmq 10 --minqual 26 --nostrays	random	17	9	3	0	29
Pilon	--fix bases --flank 9 --K 17 --mindepth 2 --minmq 26 --minqual 33	mutated	13	6	3	0	22
Pilon	--fix bases --flank 8 --K 61 --mindepth 4 --minmq 60 --minqual 27 --nostrays	random	14	8	3	1	26
Pilon	--fix all --flank 11 --K 15 --mindepth 2 --minmq 34 --minqual 28	mutated	12	17042	5979	4235	27268
Pilon	--fix bases --flank 16 --K 71 --mindepth 0.78 --minmq 45 --minqual 6	random	16	10	9	8	43
Pilon	--fix bases --flank 8 --K 17 --mindepth 2 --minmq 26 --minqual 33	mutated	13	6	3	0	22
Pilon	--fix bases --flank 10 --K 59 --mindepth 3 --minmq 40 --minqual 12	random	19	7	3	0	29
Pilon	--fix bases --flank 11 --K 15 --mindepth 2 --minmq 18 --minqual 33	mutated	12	6	3	0	21
Pilon	--fix bases --flank 0 --K 87 --mindepth 0.06 --minmq 26 --minqual 10	random	13	8	3	0	24
Pilon	--fix all --flank 11 --K 13 --mindepth 2 --minmq 21 --minqual 37	mutated	17	18	17	17	69
Pilon	--fix all --flank 8 --K 33 --mindepth 0.34 --minmq 39 --minqual 18 --nostrays	random	14	1823	350	140	2327
Pilon	--fix bases --flank 15 --K 39 --mindepth 1 --minmq 2 --minqual 20	random	98	20	8	2	128
Pilon	--fix bases --flank 11 --K 15 --mindepth 2 --minmq 18 --minqual 35	mutated	17	18	17	17	69
Pilon	--fix bases --flank 3 --K 27 --mindepth 1 --minmq 5 --minqual 38 --nostrays	random	17	18	17	17	69
Pilon	--fix bases --flank 11 --K 13 --mindepth 2 --minmq 18 --minqual 33	mutated	12	6	3	0	21
Pilon	--fix bases --flank 4 --K 33 --mindepth 2 --minmq 31 --minqual 18	random	13	6	3	0	22
Pilon	--fix bases --flank 10 --K 67 --mindepth 0.66 --minmq 4 --minqual 13 --nostrays	random	15	8	6	8	37
Pilon	--fix bases --flank 13 --K 11 --mindepth 2 --minmq 11 --minqual 33	mutated	14	6	3	0	23
Pilon	--fix bases --flank 2 --K 17 --mindepth 0.83 --minmq 12 --minqual 17	random	14	10	12	10	46
Pilon	--fix bases --flank 11 --K 11 --mindepth 2 --minmq 18 --minqual 33	mutated	12	6	3	0	21
Pilon	--fix bases --flank 3 --K 75 --mindepth 2 --minmq 19 --minqual 38	random	17	18	17	17	69
Pilon	--fix bases --flank 8 --K 11 --mindepth 2 --minmq 18 --minqual 33	mutated	13	6	3	0	22
Pilon	--fix bases --flank 19 --K 53 --mindepth 1 --minmq 25 --minqual 2	random	976	168	66	26	1236
Pilon	--fix bases --flank 1 --K 97 --mindepth 24 --minmq 52 --minqual 16 --nostrays	random	18	18	17	15	68
Pilon	--fix bases --flank 11 --K 11 --mindepth 2 --minmq 25 --minqual 33	mutated	12	6	3	0	21
Pilon	--fix bases --flank 14 --K 53 --mindepth 0.21 --minmq 19 --minqual 6	random	16	10	3	1	30
Pilon	--fix bases --flank 11 --K 11 --mindepth 1 --minmq 35 --minqual 33	mutated	47	15	7	0	69
Pilon	--fix bases --flank 7 --K 87 --mindepth 1 --minmq 15 --minqual 33 --nostrays	random	45	14	8	0	67
Pilon	--fix all --flank 4 --K 85 --mindepth 20 --minmq 8 --minqual 9	random	18	18	15	13	64
Pilon	--fix bases --flank 11 --K 11 --mindepth 2 --minmq 33 --minqual 33	mutated	12	6	3	0	21
Pilon	--fix bases --flank 7 --K 79 --mindepth 7 --minmq 16 --minqual 28	random	17	13	4	4	38
Pilon	--fix bases --flank 0 --K 11 --mindepth 22 --minmq 47 --minqual 23 --nostrays	random	18	18	16	15	67
Pilon	--fix bases --flank 11 --K 11 --mindepth 1 --minmq 33 --minqual 29	mutated	47	15	7	0	69
Pilon	--fix bases --flank 8 --K 43 --mindepth 3 --minmq 23 --minqual 14	random	12	7	3	0	22
Pilon	--fix bases --flank 11 --K 13 --mindepth 3 --minmq 33 --minqual 33	mutated	12	7	3	0	22
Pilon	--fix all --flank 17 --K 19 --mindepth 0.36 --minmq 10 --minqual 9 --nostrays	random	16	733	153	564	1466
Pilon	--fix bases --flank 11 --K 11 --mindepth 1 --minmq 33 --minqual 33	mutated	47	15	7	0	69
Pilon	--fix all --flank 2 --K 31 --mindepth 3 --minmq 32 --minqual 11	random	16	6	3	0	25
Pilon	--fix bases --flank 11 --K 11 --mindepth 3 --minmq 33 --minqual 33	mutated	12	7	3	0	22
Pilon	--fix all --flank 11 --K 35 --mindepth 0.8 --minmq 18 --minqual 24	random	15	10	358	495	878
Pilon	--fix bases --flank 12 --K 11 --mindepth 1 --minmq 33 --minqual 38	mutated	18	18	17	17	70
Pilon	--fix bases --flank 20 --K 29 --mindepth 0.38 --minmq 2 --minqual 22	random	16	10	3	2	31
Pilon	--fix bases --flank 11 --K 11 --mindepth 3 --minmq 35 --minqual 33	mutated	12	7	3	0	22
Pilon	--fix bases --flank 11 --K 77 --mindepth 5 --minmq 35 --minqual 20	random	15	8	3	1	27
Pilon	--fix bases --flank 8 --K 11 --mindepth 2 --minmq 33 --minqual 33	mutated	13	6	3	0	22
Pilon	--fix bases --flank 2 --K 13 --mindepth 9 --minmq 36 --minqual 18	random	17	13	7	4	41
Pilon	--fix all --flank 1 --K 51 --mindepth 0.59 --minmq 20 --minqual 26 --nostrays	random	14	8	4	146	172
Pilon	--fix bases --flank 11 --K 11 --mindepth 2 --minmq 32 --minqual 33	mutated	12	6	3	0	21
Pilon	--fix all --flank 9 --K 11 --mindepth 0.14 --minmq 11 --minqual 27 --nostrays	random	15	136166	32276	4644	173101
Pilon	--fix bases --flank 9 --K 11 --mindepth 2 --minmq 26 --minqual 33	mutated	13	6	3	0	22
Pilon	--fix all --flank 16 --K 21 --mindepth 10 --minmq 46 --minqual 33 --nostrays	random	18	16	1793	654	2481
Pilon	--fix all --flank 11 --K 11 --mindepth 2 --minmq 32 --minqual 34	mutated	12	144396	32771	4329	181508
Pilon	--fix all --flank 17 --K 89 --mindepth 0.74 --minmq 12 --minqual 7	random	16	10	8	5	39
Pilon	--fix bases --flank 11 --K 13 --mindepth 2 --minmq 32 --minqual 32	mutated	12	6	3	0	21
Pilon	--fix bases --flank 17 --K 31 --mindepth 0.48 --minmq 40 --minqual 19 --nostrays	random	16	10	3	4	33
Pilon	--fix bases --flank 13 --K 13 --mindepth 2 --minmq 32 --minqual 37	mutated	18	18	17	17	70
Pilon	--fix all --flank 8 --K 67 --mindepth 26 --minmq 47 --minqual 39	random	18	18	18	18	72
Pilon	--fix all --flank 0 --K 93 --mindepth 7 --minmq 19 --minqual 26 --nostrays	random	17	10	4	0	31
Pilon	--fix all --flank 11 --K 11 --mindepth 1 --minmq 32 --minqual 32	mutated	47	144404	32775	4329	181555
Pilon	--fix all --flank 16 --K 99 --mindepth 14 --minmq 32 --minqual 37	random	18	18	18	18	72
Pilon	--fix bases --flank 11 --K 15 --mindepth 2 --minmq 32 --minqual 32	mutated	12	6	3	0	21
Pilon	--fix all --flank 3 --K 39 --mindepth 3 --minmq 32 --minqual 8	random	17	6	3	0	26
Pilon	--fix all --flank 11 --K 15 --mindepth 2 --minmq 32 --minqual 32	mutated	12	17042	5979	4235	27268
Pilon	--fix all --flank 6 --K 37 --mindepth 0.7 --minmq 34 --minqual 38 --nostrays	random	17	18	18	17	70
Pilon	--fix bases --flank 11 --K 15 --mindepth 1 --minmq 32 --minqual 35	mutated	17	18	17	17	69
Pilon	--fix bases --flank 15 --K 45 --mindepth 0.09 --minmq 56 --minqual 25	random	16	10	3	2	31
Pilon	--fix all --flank 8 --K 93 --mindepth 0.73 --minmq 7 --minqual 10 --nostrays	random	14	9	7	8	38
Pilon	--fix bases --flank 4 --K 63 --mindepth 0.38 --minmq 19 --minqual 38	random	17	18	17	17	69
Pilon	--fix bases --flank 14 --K 13 --mindepth 2 --minmq 32 --minqual 29	mutated	14	6	3	0	23
Pilon	--fix all --flank 8 --K 17 --mindepth 0.67 --minmq 25 --minqual 2	random	14	158	730	571	1473
Pilon	--fix all --flank 4 --K 19 --mindepth 0.51 --minmq 60 --minqual 28 --nostrays	random	14	1171	154	916	2255
Pilon	--fix bases --flank 2 --K 51 --mindepth 21 --minmq 1 --minqual 11	random	18	18	15	13	64
Pilon	--fix bases --flank 1 --K 37 --mindepth 0.36 --minmq 57 --minqual 34 --nostrays	random	14	8	3	2	27
Pilon	--fix bases --flank 11 --K 13 --mindepth 2 --minmq 41 --minqual 32	mutated	12	6	3	1	22
Pilon	--fix all --flank 16 --K 23 --mindepth 13 --minmq 8 --minqual 13 --nostrays	random	18	1832	510	12	2372
Pilon	--fix all --flank 17 --K 53 --mindepth 22 --minmq 13 --minqual 16	random	18	18	18	18	72
Pilon	--fix all --flank 10 --K 21 --mindepth 0.32 --minmq 56 --minqual 39 --nostrays	random	17	18	17	17	69
Pilon	--fix bases --flank 11 --K 15 --mindepth 1 --minmq 29 --minqual 32	mutated	47	15	7	0	69
Pilon	--fix all --flank 9 --K 51 --mindepth 13 --minmq 58 --minqual 28 --nostrays	random	18	17	13	10	58
Pilon	--fix bases --flank 11 --K 15 --mindepth 3 --minmq 39 --minqual 32	mutated	12	7	3	0	22
Pilon	--fix bases --flank 15 --K 57 --mindepth 4 --minmq 27 --minqual 20	random	16	8	3	1	28
Pilon	--fix bases --flank 10 --K 15 --mindepth 2 --minmq 32 --minqual 33	mutated	13	6	3	0	22
Pilon	--fix all --flank 7 --K 85 --mindepth 0.08 --minmq 25 --minqual 35 --nostrays	random	17	18	17	17	69
Pilon	--fix bases --flank 11 --K 15 --mindepth 2 --minmq 32 --minqual 27	mutated	12	6	3	0	21
Pilon	--fix bases --flank 14 --K 77 --mindepth 11 --minmq 1 --minqual 24	random	18	15	12	8	53
Pilon	--fix bases --flank 14 --K 85 --mindepth 6 --minmq 24 --minqual 28 --nostrays	random	17	11	4	4	36
Pilon	--fix bases --flank 11 --K 13 --mindepth 2 --minmq 24 --minqual 27	mutated	12	6	3	0	21
Pilon	--fix bases --flank 8 --K 35 --mindepth 4 --minmq 45 --minqual 20 --nostrays	random	14	8	3	0	25
Pilon	--fix all --flank 11 --K 13 --mindepth 2 --minmq 24 --minqual 27	mutated	12	23354	19063	7692	50121
Pilon	--fix all --flank 1 --K 73 --mindepth 0.04 --minmq 34 --minqual 16	random	14	8	3	0	25
Pilon	--fix all --flank 11 --K 13 --mindepth 1 --minmq 24 --minqual 27	mutated	47	23363	19067	7692	50169
Pilon	--fix all --flank 11 --K 89 --mindepth 2 --minmq 28 --minqual 15	random	13	6	3	0	22
Pilon	--fix bases --flank 11 --K 11 --mindepth 2 --minmq 30 --minqual 27	mutated	12	6	3	0	21
Pilon	--fix all --flank 13 --K 23 --mindepth 1 --minmq 41 --minqual 30	random	51	13	1169	1	1234
Pilon	--fix bases --flank 0 --K 19 --mindepth 11 --minmq 6 --minqual 4	random	17	13	8	6	44
Pilon	--fix bases --flank 1 --K 29 --mindepth 26 --minmq 38 --minqual 29 --nostrays	random	18	18	18	18	72
Pilon	--fix bases --flank 9 --K 11 --mindepth 2 --minmq 30 --minqual 27	mutated	13	6	3	0	22
Pilon	--fix all --flank 13 --K 75 --mindepth 0.13 --minmq 6 --minqual 11	random	16	147	3	1	167
Pilon	--fix bases --flank 14 --K 11 --mindepth 2 --minmq 30 --minqual 27	mutated	14	6	3	0	23
Pilon	--fix all --flank 6 --K 95 --mindepth 0.7 --minmq 2 --minqual 2 --nostrays	random	14	9	7	8	38
Pilon	--fix bases --flank 11 --K 11 --mindepth 2 --minmq 30 --minqual 32	mutated	12	6	3	0	21
Pilon	--fix bases --flank 3 --K 95 --mindepth 0.86 --minmq 40 --minqual 20	random	14	10	12	10	46
Pilon	--fix bases --flank 10 --K 13 --mindepth 1 --minmq 30 --minqual 32	mutated	46	15	7	0	68
Pilon	--fix bases --flank 2 --K 39 --mindepth 6 --minmq 13 --minqual 11 --nostrays	random	17	8	3	0	28
Pilon	--fix bases --flank 11 --K 13 --mindepth 2 --minmq 30 --minqual 32	mutated	12	6	3	0	21
Pilon	--fix all --flank 6 --K 13 --mindepth 14 --minmq 35 --minqual 22	random	6004	10813	7611	2616	27044
Pilon	--fix bases --flank 11 --K 13 --mindepth 2 --minmq 23 --minqual 32	mutated	12	6	3	0	21
Pilon	--fix all --flank 18 --K 91 --mindepth 0.95 --minmq 50 --minqual 30 --nostrays	random	16	14	13	14	57
Pilon	--fix bases --flank 14 --K 13 --mindepth 2 --minmq 23 --minqual 32	mutated	14	6	3	0	23
Pilon	--fix bases --flank 12 --K 15 --mindepth 0.25 --minmq 26 --minqual 3	random	16	8	3	0	27
Pilon	--fix bases --flank 11 --K 13 --mindepth 3 --minmq 23 --minqual 32	mutated	12	7	3	0	22
Pilon	--fix all --flank 6 --K 53 --mindepth 24 --minmq 60 --minqual 17	random	18	18	18	155	209
Pilon	--fix bases --flank 11 --K 13 --mindepth 2 --minmq 16 --minqual 32	mutated	12	6	3	0	21
Pilon	--fix bases --flank 10 --K 13 --mindepth 2 --minmq 21 --minqual 3	random	29	7	4	0	40
Pilon	--fix bases --flank 11 --K 13 --mindepth 1 --minmq 16 --minqual 29	mutated	47	15	7	0	69
Pilon	--fix all --flank 18 --K 15 --mindepth 8 --minmq 27 --minqual 8	random	18	5448	2869	791	9126
Pilon	--fix all --flank 11 --K 13 --mindepth 2 --minmq 16 --minqual 32	mutated	12	23354	19063	7692	50121
Pilon	--fix all --flank 5 --K 21 --mindepth 0.73 --minmq 43 --minqual 25 --nostrays	random	14	1825	505	9	2353
Pilon	--fix all --flank 9 --K 93 --mindepth 7 --minmq 12 --minqual 13	random	17	13	5	140	175
Pilon	--fix bases --flank 18 --K 19 --mindepth 7 --minmq 29 --minqual 23	random	18	14	7	4	43
Pilon	--fix bases --flank 11 --K 13 --mindepth 2 --minmq 16 --minqual 35	mutated	17	18	17	17	69
Pilon	--fix all --flank 4 --K 79 --mindepth 6 --minmq 12 --minqual 20	random	17	9	3	138	167
Pilon	--fix bases --flank 12 --K 13 --mindepth 2 --minmq 16 --minqual 32	mutated	14	6	3	0	23
Pilon	--fix all --flank 0 --K 21 --mindepth 10 --minmq 60 --minqual 34 --nostrays	random	17	299	9	352	677
Pilon	--fix bases --flank 5 --K 49 --mindepth 0.72 --minmq 38 --minqual 15 --nostrays	random	14	9	8	9	40
Pilon	--fix bases --flank 11 --K 13 --mindepth 2 --minmq 16 --minqual 31	mutated	12	6	3	0	21
Pilon	--fix all --flank 0 --K 17 --mindepth 4 --minmq 56 --minqual 8 --nostrays	random	12	157	3	564	736
Pilon	--fix bases --flank 11 --K 11 --mindepth 1 --minmq 16 --minqual 31	mutated	47	15	7	0	69
Pilon	--fix bases --flank 19 --K 61 --mindepth 0.01 --minmq 28 --minqual 38	random	18	18	17	17	70
Pilon	--fix bases --flank 11 --K 15 --mindepth 2 --minmq 16 --minqual 31	mutated	12	6	3	0	21
Pilon	--fix bases --flank 12 --K 99 --mindepth 2 --minmq 51 --minqual 19 --nostrays	random	15	6	3	0	24
Pilon	--fix bases --flank 11 --K 15 --mindepth 2 --minmq 15 --minqual 31	mutated	12	6	3	0	21
Pilon	--fix bases --flank 18 --K 45 --mindepth 0.71 --minmq 17 --minqual 11 --nostrays	random	16	10	6	5	37
Pilon	--fix bases --flank 11 --K 13 --mindepth 2 --minmq 15 --minqual 31	mutated	12	6	3	0	21
Pilon	--fix bases --flank 15 --K 65 --mindepth 1 --minmq 22 --minqual 2	random	856	124	55	17	1052
Pilon	--fix all --flank 15 --K 43 --mindepth 12 --minmq 54 --minqual 27 --nostrays	random	18	17	13	10	58
Pilon	--fix bases --flank 10 --K 13 --mindepth 2 --minmq 15 --minqual 31	mutated	13	6	3	0	22
Pilon	--fix bases --flank 16 --K 69 --mindepth 0.84 --minmq 10 --minqual 21	random	16	10	12	10	48
Pilon	--fix all --flank 11 --K 13 --mindepth 2 --minmq 15 --minqual 31	mutated	12	23354	19063	7692	50121
Pilon	--fix all --flank 16 --K 77 --mindepth 0.41 --minmq 59 --minqual 5	random	16	10	3	2	31
Pilon	--fix bases --flank 11 --K 13 --mindepth 2 --minmq 15 --minqual 30	mutated	12	6	3	0	21
Pilon	--fix all --flank 4 --K 25 --mindepth 0.16 --minmq 20 --minqual 21 --nostrays	random	14	1823	350	0	2187
Pilon	--fix all --flank 11 --K 13 --mindepth 2 --minmq 12 --minqual 30	mutated	12	23354	19063	7692	50121
Pilon	--fix all --flank 20 --K 11 --mindepth 2 --minmq 58 --minqual 36	random	18	18	17	17	70
Pilon	--fix bases --flank 11 --K 13 --mindepth 1 --minmq 15 --minqual 30	mutated	47	15	7	0	69
Pilon	--fix bases --flank 16 --K 23 --mindepth 26 --minmq 47 --minqual 3 --nostrays	random	18	18	18	18	72
Pilon	--fix bases --flank 11 --K 11 --mindepth 2 --minmq 17 --minqual 29	mutated	12	6	3	0	21
Pilon	--fix all --flank 7 --K 83 --mindepth 2 --minmq 21 --minqual 0	random	27	7	4	0	38
Pilon	--fix bases --flank 2 --K 21 --mindepth 0.57 --minmq 50 --minqual 28	random	14	8	7	5	34
Pilon	--fix bases --flank 11 --K 11 --mindepth 2 --minmq 17 --minqual 25	mutated	13	6	3	0	22
Pilon	--fix all --flank 9 --K 65 --mindepth 4 --minmq 26 --minqual 18 --nostrays	random	14	8	3	138	163
Pilon	--fix all --flank 13 --K 21 --mindepth 1 --minmq 54 --minqual 35 --nostrays	random	18	18	17	17	70
Pilon	--fix bases --flank 11 --K 11 --mindepth 3 --minmq 17 --minqual 29	mutated	12	7	3	0	22
Pilon	--fix all --flank 7 --K 55 --mindepth 1 --minmq 29 --minqual 37 --nostrays	random	17	18	17	17	69
Pilon	--fix all --flank 11 --K 13 --mindepth 2 --minmq 17 --minqual 29	mutated	12	23354	19063	7692	50121
Pilon	--fix all --flank 6 --K 95 --mindepth 2 --minmq 8 --minqual 7	random	28	7	3	0	38
Pilon	--fix bases --flank 10 --K 15 --mindepth 18 --minmq 0 --minqual 12	random	18	18	15	14	65
Pilon	--fix bases --flank 11 --K 11 --mindepth 2 --minmq 11 --minqual 24	mutated	13	6	3	0	22
Pilon	--fix all --flank 11 --K 91 --mindepth 0.78 --minmq 35 --minqual 8 --nostrays	random	15	10	8	8	41
Pilon	--fix bases --flank 11 --K 95 --mindepth 0.2 --minmq 13 --minqual 26 --nostrays	random	15	8	3	1	27
Pilon	--fix all --flank 4 --K 83 --mindepth 0.62 --minmq 37 --minqual 16	random	14	9	5	8	36
Pilon	--fix bases --flank 11 --K 11 --mindepth 1 --minmq 21 --minqual 27	mutated	47	15	7	0	69
Pilon	--fix all --flank 6 --K 93 --mindepth 1 --minmq 37 --minqual 23 --nostrays	random	72	18	6	1	97
Pilon	--fix bases --flank 4 --K 41 --mindepth 0.04 --minmq 57 --minqual 26 --nostrays	random	14	8	3	0	25
Pilon	--fix all --flank 5 --K 31 --mindepth 0.96 --minmq 54 --minqual 40	random	17	18	18	18	71
Pilon	--fix all --flank 8 --K 99 --mindepth 9 --minmq 2 --minqual 6 --nostrays	random	17	12	7	3	39
Pilon	--fix bases --flank 11 --K 11 --mindepth 1 --minmq 17 --minqual 29	mutated	47	15	7	0	69
Pilon	--fix bases --flank 17 --K 35 --mindepth 0.32 --minmq 26 --minqual 5 --nostrays	random	16	10	3	0	29
Pilon	--fix bases --flank 0 --K 59 --mindepth 22 --minmq 20 --minqual 8 --nostrays	random	18	18	15	15	66
Pilon	--fix bases --flank 8 --K 11 --mindepth 2 --minmq 9 --minqual 29	mutated	13	6	3	0	22
Pilon	--fix all --flank 9 --K 97 --mindepth 13 --minmq 53 --minqual 23	random	18	16	13	10	57
Pilon	--fix bases --flank 13 --K 11 --mindepth 2 --minmq 17 --minqual 29	mutated	14	6	3	0	23
Pilon	--fix all --flank 18 --K 67 --mindepth 0.5 --minmq 53 --minqual 31	random	16	10	4	5	35
Pilon	--fix bases --flank 11 --K 79 --mindepth 0.45 --minmq 33 --minqual 38 --nostrays	random	17	18	17	17	69
Pilon	--fix all --flank 11 --K 11 --mindepth 2 --minmq 17 --minqual 29	mutated	12	144396	32771	4329	181508
Pilon	--fix all --flank 12 --K 21 --mindepth 0.61 --minmq 40 --minqual 17 --nostrays	random	16	8	503	352	879
Pilon	--fix all --flank 9 --K 11 --mindepth 2 --minmq 17 --minqual 29	mutated	13	136164	32276	4643	173096
Pilon	--fix all --flank 12 --K 81 --mindepth 0.31 --minmq 57 --minqual 25	random	16	8	3	1	28
Pilon	--fix bases --flank 11 --K 11 --mindepth 2 --minmq 8 --minqual 29	mutated	12	6	3	0	21
Pilon	--fix all --flank 2 --K 57 --mindepth 2 --minmq 23 --minqual 40 --nostrays	random	17	18	17	17	69
Pilon	--fix bases --flank 9 --K 11 --mindepth 2 --minmq 8 --minqual 29	mutated	13	6	3	0	22
Pilon	--fix bases --flank 12 --K 31 --mindepth 3 --minmq 53 --minqual 37	random	18	18	17	17	70
Pilon	--fix all --flank 7 --K 47 --mindepth 10 --minmq 6 --minqual 14 --nostrays	random	18	1828	9	143	1998
Pilon	--fix bases --flank 18 --K 99 --mindepth 1 --minmq 30 --minqual 10 --nostrays	random	939	160	62	19	1180
Pilon	--fix all --flank 13 --K 43 --mindepth 0.25 --minmq 29 --minqual 16	random	16	9	3	349	377
Pilon	--fix all --flank 2 --K 17 --mindepth 0.4 --minmq 52 --minqual 9	random	14	158	576	565	1313
Pilon	--fix bases --flank 11 --K 13 --mindepth 2 --minmq 8 --minqual 29	mutated	12	6	3	0	21
Pilon	--fix bases --flank 17 --K 89 --mindepth 0.21 --minmq 36 --minqual 30	random	16	10	4	3	33
Pilon	--fix bases --flank 10 --K 11 --mindepth 1 --minmq 8 --minqual 29	mutated	46	15	7	0	68
Pilon	--fix all --flank 20 --K 65 --mindepth 1 --minmq 2 --minqual 4	random	1012	180	68	29	1289
Pilon	--fix all --flank 11 --K 13 --mindepth 2 --minmq 17 --minqual 30	mutated	12	23354	19063	7692	50121
Pilon	--fix all --flank 1 --K 45 --mindepth 7 --minmq 52 --minqual 2 --nostrays	random	17	10	350	1	378
Pilon	--fix all --flank 5 --K 41 --mindepth 1 --minmq 16 --minqual 37 --nostrays	random	17	18	17	17	69
Pilon	--fix bases --flank 8 --K 15 --mindepth 2 --minmq 8 --minqual 29	mutated	13	6	3	0	22
Pilon	--fix bases --flank 5 --K 87 --mindepth 17 --minmq 57 --minqual 16 --nostrays	random	18	18	13	11	60
Pilon	--fix bases --flank 11 --K 13 --mindepth 2 --minmq 1 --minqual 32	mutated	12	6	3	0	21
Pilon	--fix all --flank 0 --K 19 --mindepth 0.5 --minmq 56 --minqual 11	random	13	158	3	567	741
Pilon	--fix all --flank 14 --K 49 --mindepth 0.34 --minmq 40 --minqual 38	random	18	18	17	17	70
Pilon	--fix bases --flank 11 --K 15 --mindepth 2 --minmq 0 --minqual 32	mutated	18	7	3	0	28
Pilon	--fix all --flank 16 --K 49 --mindepth 0.98 --minmq 25 --minqual 6 --nostrays	random	16	10	11	360	397
Pilon	--fix bases --flank 11 --K 13 --mindepth 2 --minmq 1 --minqual 27	mutated	12	6	3	0	21
Pilon	--fix all --flank 14 --K 11 --mindepth 8 --minmq 25 --minqual 30 --nostrays	random	17	0	43553	5171	48741
Pilon	--fix bases --flank 14 --K 13 --mindepth 2 --minmq 8 --minqual 25	mutated	15	6	3	1	25
Pilon	--fix bases --flank 0 --K 25 --mindepth 24 --minmq 14 --minqual 7	random	18	18	16	15	67
Pilon	--fix bases --flank 11 --K 13 --mindepth 2 --minmq 1 --minqual 28	mutated	12	6	3	0	21
Pilon	--fix bases --flank 13 --K 69 --mindepth 0.97 --minmq 21 --minqual 31	random	16	13	13	12	54
Pilon	--fix bases --flank 8 --K 13 --mindepth 3 --minmq 2 --minqual 28	mutated	12	7	3	0	22
Pilon	--fix bases --flank 18 --K 27 --mindepth 0.77 --minmq 27 --minqual 39 --nostrays	random	18	18	18	17	71
Pilon	--fix bases --flank 14 --K 13 --mindepth 3 --minmq 1 --minqual 28	mutated	13	8	3	0	24
Pilon	--fix bases --flank 7 --K 25 --mindepth 4 --minmq 51 --minqual 36	random	17	18	17	17	69
Pilon	--fix bases --flank 3 --K 17 --mindepth 11 --minmq 51 --minqual 10 --nostrays	random	17	13	8	7	45
Pilon	--fix all --flank 11 --K 13 --mindepth 2 --minmq 1 --minqual 25	mutated	13	16701	10832	2288	29834
Pilon	--fix bases --flank 11 --K 35 --mindepth 5 --minmq 20 --minqual 9	random	15	8	3	0	26
Pilon	--fix all --flank 12 --K 13 --mindepth 1 --minmq 1 --minqual 28	mutated	49	16336	25210	9325	50920
Pilon	--fix all --flank 6 --K 69 --mindepth 2 --minmq 7 --minqual 22	random	13	6	3	138	160
Pilon	--fix bases --flank 8 --K 99 --mindepth 0.17 --minmq 39 --minqual 26 --nostrays	random	14	8	3	1	26
Pilon	--fix bases --flank 11 --K 11 --mindepth 2 --minmq 1 --minqual 28	mutated	12	6	3	0	21
Pilon	--fix all --flank 8 --K 13 --mindepth 4 --minmq 57 --minqual 29 --nostrays	random	14	16295	14459	9847	40615
Pilon	--fix bases --flank 10 --K 13 --mindepth 23 --minmq 56 --minqual 20	random	18	18	18	18	72
Pilon	--fix all --flank 10 --K 51 --mindepth 2 --minmq 43 --minqual 17 --nostrays	random	14	6	3	0	23
Pilon	--fix all --flank 9 --K 11 --mindepth 2 --minmq 1 --minqual 28	mutated	13	136164	32276	4643	173096
Pilon	--fix all --flank 4 --K 93 --mindepth 13 --minmq 29 --minqual 36 --nostrays	random	18	18	18	18	72
Pilon	--fix bases --flank 11 --K 11 --mindepth 1 --minmq 1 --minqual 28	mutated	47	15	7	0	69
Pilon	--fix bases --flank 17 --K 49 --mindepth 7 --minmq 48 --minqual 2	random	17	11	6	4	38
Pilon	--fix all --flank 13 --K 65 --mindepth 0.97 --minmq 46 --minqual 25	random	16	13	12	12	53
Pilon	--fix all --flank 11 --K 11 --mindepth 2 --minmq 1 --minqual 28	mutated	12	144396	32771	4329	181508
Pilon	--fix all --flank 3 --K 37 --mindepth 18 --minmq 56 --minqual 38	random	18	18	18	18	72
Pilon	--fix bases --flank 11 --K 11 --mindepth 2 --minmq 10 --minqual 28	mutated	12	6	3	0	21
Pilon	--fix all --flank 5 --K 15 --mindepth 17 --minmq 58 --minqual 36 --nostrays	random	18	18	18	18	72
Pilon	--fix bases --flank 11 --K 11 --mindepth 2 --minmq 10 --minqual 29	mutated	12	6	3	0	21
Pilon	--fix bases --flank 7 --K 63 --mindepth 2 --minmq 18 --minqual 25 --nostrays	random	13	6	3	0	22
Pilon	--fix bases --flank 10 --K 45 --mindepth 0.33 --minmq 41 --minqual 13 --nostrays	random	15	8	3	1	27
Pilon	--fix bases --flank 9 --K 11 --mindepth 2 --minmq 10 --minqual 29	mutated	13	6	3	0	22
Pilon	--fix bases --flank 13 --K 45 --mindepth 0.9 --minmq 24 --minqual 9	random	16	10	10	10	46
Pilon	--fix all --flank 0 --K 41 --mindepth 10 --minmq 57 --minqual 29	random	17	14	9	143	183
Pilon	--fix all --flank 2 --K 51 --mindepth 2 --minmq 1 --minqual 16	random	13	5	3	138	159
Pilon	--fix all --flank 11 --K 11 --mindepth 2 --minmq 10 --minqual 29	mutated	12	144396	32771	4329	181508
Pilon	--fix all --flank 17 --K 63 --mindepth 2 --minmq 38 --minqual 1 --nostrays	random	35	7	3	0	45
Pilon	--fix bases --flank 11 --K 11 --mindepth 2 --minmq 6 --minqual 32	mutated	12	6	3	0	21
Pilon	--fix all --flank 17 --K 89 --mindepth 7 --minmq 4 --minqual 5	random	17	11	6	4	38
Pilon	--fix bases --flank 14 --K 11 --mindepth 2 --minmq 6 --minqual 32	mutated	14	6	3	0	23
Pilon	--fix bases --flank 9 --K 57 --mindepth 0.96 --minmq 9 --minqual 33	random	15	13	13	11	52
Pilon	--fix all --flank 11 --K 11 --mindepth 2 --minmq 6 --minqual 32	mutated	12	144396	32771	4329	181508
Pilon	--fix all --flank 14 --K 47 --mindepth 14 --minmq 59 --minqual 26	random	18	1833	13	358	2222
Pilon	--fix bases --flank 11 --K 13 --mindepth 2 --minmq 6 --minqual 32	mutated	12	6	3	0	21
Pilon	--fix bases --flank 2 --K 17 --mindepth 0.91 --minmq 30 --minqual 36 --nostrays	random	17	18	18	18	71
Pilon	--fix bases --flank 11 --K 15 --mindepth 2 --minmq 4 --minqual 31	mutated	12	6	3	0	21
Pilon	--fix bases --flank 17 --K 77 --mindepth 0.92 --minmq 23 --minqual 32 --nostrays	random	16	11	12	13	52
Pilon	--fix bases --flank 11 --K 15 --mindepth 1 --minmq 4 --minqual 31	mutated	47	15	7	0	69
Pilon	--fix bases --flank 4 --K 63 --mindepth 25 --minmq 28 --minqual 17 --nostrays	random	18	18	18	18	72
Pilon	--fix bases --flank 11 --K 15 --mindepth 2 --minmq 0 --minqual 31	mutated	18	7	3	0	28
Pilon	--fix all --flank 9 --K 53 --mindepth 9 --minmq 19 --minqual 15 --nostrays	random	17	13	9	142	181
Pilon	--fix all --flank 19 --K 17 --mindepth 4 --minmq 17 --minqual 31 --nostrays	random	16	10	3599	1359	4984
Pilon	--fix bases --flank 10 --K 33 --mindepth 0.31 --minmq 24 --minqual 8	random	15	8	3	0	26
Pilon	--fix bases --flank 11 --K 13 --mindepth 2 --minmq 4 --minqual 31	mutated	12	6	3	0	21
Pilon	--fix bases --flank 7 --K 33 --mindepth 0.39 --minmq 28 --minqual 16	random	14	8	3	2	27
Pilon	--fix bases --flank 11 --K 15 --mindepth 2 --minmq 2 --minqual 31	mutated	12	6	3	0	21
Pilon	--fix bases --flank 18 --K 41 --mindepth 18 --minmq 57 --minqual 26	random	18	18	16	17	69
Pilon	--fix bases --flank 11 --K 15 --mindepth 3 --minmq 2 --minqual 33	mutated	12	7	3	0	22
Pilon	--fix bases --flank 18 --K 41 --mindepth 0.37 --minmq 28 --minqual 28	random	16	10	4	3	33
Pilon	--fix bases --flank 11 --K 13 --mindepth 2 --minmq 2 --minqual 35	mutated	17	18	17	17	69
Pilon	--fix all --flank 19 --K 69 --mindepth 24 --minmq 9 --minqual 35	random	18	18	18	18	72
Pilon	--fix bases --flank 12 --K 15 --mindepth 2 --minmq 2 --minqual 27	mutated	14	6	3	0	23
Pilon	--fix bases --flank 7 --K 75 --mindepth 16 --minmq 24 --minqual 26 --nostrays	random	18	18	13	13	62
Pilon	--fix bases --flank 11 --K 15 --mindepth 2 --minmq 2 --minqual 32	mutated	12	6	3	0	21
Pilon	--fix bases --flank 4 --K 77 --mindepth 22 --minmq 46 --minqual 3 --nostrays	random	18	18	15	15	66
Pilon	--fix all --flank 9 --K 15 --mindepth 0.77 --minmq 26 --minqual 5	random	15	3366	1422	795	5598
Pilon	--fix bases --flank 11 --K 17 --mindepth 2 --minmq 2 --minqual 32	mutated	12	6	3	0	21
Pilon	--fix bases --flank 7 --K 41 --mindepth 0.31 --minmq 31 --minqual 38	random	17	18	17	17	69
Pilon	--fix bases --flank 13 --K 17 --mindepth 3 --minmq 2 --minqual 32	mutated	13	8	3	0	24
Pilon	--fix bases --flank 11 --K 73 --mindepth 0.61 --minmq 4 --minqual 36 --nostrays	random	17	18	18	17	70
Pilon	--fix bases --flank 6 --K 47 --mindepth 7 --minmq 14 --minqual 26 --nostrays	random	17	11	4	2	34
Pilon	--fix bases --flank 14 --K 17 --mindepth 2 --minmq 2 --minqual 32	mutated	14	6	3	0	23
Pilon	--fix bases --flank 8 --K 55 --mindepth 11 --minmq 41 --minqual 36 --nostrays	random	18	18	18	17	71
Pilon	--fix bases --flank 12 --K 17 --mindepth 2 --minmq 8 --minqual 32	mutated	14	6	3	0	23
Pilon	--fix all --flank 18 --K 39 --mindepth 0.6 --minmq 58 --minqual 39	random	18	18	17	17	70
Pilon	--fix bases --flank 1 --K 91 --mindepth 1.0 --minmq 35 --minqual 15 --nostrays	random	62	11	5	1	79
Pilon	--fix bases --flank 11 --K 19 --mindepth 2 --minmq 2 --minqual 32	mutated	12	6	3	0	21
Pilon	--fix bases --flank 3 --K 29 --mindepth 7 --minmq 18 --minqual 23 --nostrays	random	17	10	4	0	31
Pilon	--fix bases --flank 9 --K 19 --mindepth 2 --minmq 2 --minqual 32	mutated	13	6	3	0	22
Pilon	--fix bases --flank 15 --K 53 --mindepth 8 --minmq 48 --minqual 29 --nostrays	random	18	14	11	5	48
Pilon	--fix all --flank 8 --K 45 --mindepth 0.54 --minmq 4 --minqual 12 --nostrays	random	14	8	4	3	29
Pilon	--fix bases --flank 11 --K 19 --mindepth 2 --minmq 0 --minqual 34	mutated	18	7	3	0	28
Pilon	--fix all --flank 6 --K 19 --mindepth 0.48 --minmq 30 --minqual 33 --nostrays	random	14	8	1501	915	2438
Pilon	--fix all --flank 11 --K 19 --mindepth 2 --minmq 3 --minqual 32	mutated	12	6	1934	1560	3512
Pilon	--fix all --flank 11 --K 25 --mindepth 11 --minmq 12 --minqual 28 --nostrays	random	18	16	13	493	540
Pilon	--fix bases --flank 14 --K 97 --mindepth 13 --minmq 59 --minqual 23 --nostrays	random	18	17	13	11	59
Pilon	--fix all --flank 18 --K 97 --mindepth 27 --minmq 13 --minqual 5	random	18	18	18	18	72
Pilon	--fix bases --flank 5 --K 61 --mindepth 23 --minmq 60 --minqual 8	random	18	18	16	17	69
Pilon	--fix bases --flank 11 --K 19 --mindepth 2 --minmq 2 --minqual 30	mutated	12	6	3	0	21
Pilon	--fix bases --flank 0 --K 93 --mindepth 0.54 --minmq 31 --minqual 39	random	17	18	18	17	70
Pilon	--fix all --flank 11 --K 25 --mindepth 0.38 --minmq 21 --minqual 27	random	15	8	3	489	515
Pilon	--fix all --flank 11 --K 19 --mindepth 2 --minmq 2 --minqual 30	mutated	12	6	1934	1560	3512
Pilon	--fix bases --flank 10 --K 39 --mindepth 19 --minmq 1 --minqual 26	random	18	18	15	15	66
Pilon	--fix all --flank 11 --K 19 --mindepth 3 --minmq 2 --minqual 30	mutated	12	7	1934	1560	3513
Pilon	--fix all --flank 20 --K 69 --mindepth 0.93 --minmq 7 --minqual 36	random	18	18	18	18	72
Pilon	--fix bases --flank 11 --K 19 --mindepth 3 --minmq 2 --minqual 30	mutated	12	7	3	0	22
Pilon	--fix bases --flank 20 --K 91 --mindepth 3 --minmq 21 --minqual 1 --nostrays	random	18	8	3	0	29
Pilon	--fix bases --flank 10 --K 65 --mindepth 0.84 --minmq 41 --minqual 22	random	15	13	10	10	48
Pilon	--fix bases --flank 11 --K 19 --mindepth 1 --minmq 2 --minqual 30	mutated	47	15	7	0	69
Pilon	--fix bases --flank 2 --K 23 --mindepth 12 --minmq 39 --minqual 23	random	17	16	12	8	53
Pilon	--fix bases --flank 11 --K 17 --mindepth 2 --minmq 2 --minqual 30	mutated	12	6	3	0	21
Pilon	--fix all --flank 20 --K 31 --mindepth 0.06 --minmq 52 --minqual 30	random	16	10	1167	3	1196
Pilon	--fix all --flank 5 --K 75 --mindepth 5 --minmq 26 --minqual 36	random	17	18	17	17	69
Pilon	--fix all --flank 10 --K 17 --mindepth 2 --minmq 2 --minqual 25	mutated	14	1821	153	564	2552
Pilon	--fix all --flank 0 --K 63 --mindepth 5 --minmq 45 --minqual 31 --nostrays	random	13	8	3	1	25
Pilon	--fix bases --flank 1 --K 45 --mindepth 6 --minmq 52 --minqual 4	random	17	8	3	0	28
Pilon	--fix bases --flank 11 --K 15 --mindepth 3 --minmq 2 --minqual 30	mutated	12	7	3	0	22
Pilon	--fix all --flank 17 --K 29 --mindepth 0.56 --minmq 6 --minqual 33	random	16	10	4	5	35
Pilon	--fix bases --flank 11 --K 17 --mindepth 2 --minmq 6 --minqual 30	mutated	12	6	3	0	21
Pilon	--fix bases --flank 6 --K 79 --mindepth 14 --minmq 46 --minqual 32 --nostrays	random	18	18	13	11	60
Pilon	--fix all --flank 5 --K 83 --mindepth 0.48 --minmq 58 --minqual 2	random	14	8	3	141	166
Pilon	--fix bases --flank 11 --K 17 --mindepth 2 --minmq 13 --minqual 30	mutated	12	6	3	0	21
Pilon	--fix all --flank 20 --K 85 --mindepth 25 --minmq 13 --minqual 31 --nostrays	random	18	18	18	18	72
Pilon	--fix bases --flank 13 --K 15 --mindepth 2 --minmq 13 --minqual 31	mutated	14	6	3	0	23
Pilon	--fix all --flank 14 --K 65 --mindepth 0.1 --minmq 6 --minqual 4 --nostrays	random	16	10	3	1	30
Pilon	--fix bases --flank 11 --K 17 --mindepth 2 --minmq 13 --minqual 28	mutated	12	6	3	0	21
Pilon	--fix all --flank 4 --K 71 --mindepth 0.92 --minmq 8 --minqual 28	random	14	11	13	149	187
Pilon	--fix all --flank 2 --K 33 --mindepth 0.3 --minmq 36 --minqual 22 --nostrays	random	14	1823	3	138	1978
Pilon	--fix all --flank 12 --K 41 --mindepth 0.59 --minmq 13 --minqual 32	random	16	8	8	352	384
Pilon	--fix all --flank 11 --K 17 --mindepth 2 --minmq 13 --minqual 28	mutated	12	6	2357	1878	4253
Pilon	--fix all --flank 4 --K 77 --mindepth 7 --minmq 29 --minqual 10 --nostrays	random	17	10	3	1	31
Pilon	--fix bases --flank 10 --K 59 --mindepth 4 --minmq 18 --minqual 39	random	17	18	17	17	69
Pilon	--fix bases --flank 8 --K 49 --mindepth 0.87 --minmq 51 --minqual 3	random	14	10	10	10	44
Pilon	--fix bases --flank 12 --K 17 --mindepth 2 --minmq 13 --minqual 28	mutated	14	6	3	0	23
Pilon	--fix all --flank 14 --K 47 --mindepth 0.9 --minmq 14 --minqual 21	random	16	1825	12	358	2211
Pilon	--fix all --flank 3 --K 17 --mindepth 1 --minmq 52 --minqual 1	random	529	181	586	569	1865
Pilon	--fix bases --flank 11 --K 17 --mindepth 1 --minmq 13 --minqual 28	mutated	47	15	7	0	69
Pilon	--fix all --flank 10 --K 99 --mindepth 15 --minmq 28 --minqual 1	random	18	18	13	10	59
Pilon	--fix bases --flank 11 --K 17 --mindepth 3 --minmq 13 --minqual 28	mutated	12	7	3	0	22
Pilon	--fix bases --flank 2 --K 91 --mindepth 0.43 --minmq 19 --minqual 20 --nostrays	random	14	8	3	2	27
Pilon	--fix bases --flank 11 --K 17 --mindepth 2 --minmq 21 --minqual 28	mutated	12	6	3	0	21
Pilon	--fix all --flank 18 --K 81 --mindepth 0.26 --minmq 53 --minqual 2	random	16	10	3	0	29
Pilon	--fix all --flank 11 --K 17 --mindepth 2 --minmq 28 --minqual 28	mutated	12	6	2357	1878	4253
Pilon	--fix all --flank 9 --K 51 --mindepth 21 --minmq 29 --minqual 28	random	18	18	17	156	209
Pilon	--fix bases --flank 11 --K 17 --mindepth 2 --minmq 30 --minqual 28	mutated	12	6	3	0	21
Pilon	--fix all --flank 6 --K 91 --mindepth 0.64 --minmq 34 --minqual 16	random	14	9	5	8	36
Pilon	--fix bases --flank 11 --K 15 --mindepth 2 --minmq 30 --minqual 26	mutated	13	6	3	0	22
Pilon	--fix bases --flank 0 --K 19 --mindepth 0.95 --minmq 54 --minqual 36 --nostrays	random	17	18	18	18	71
Pilon	--fix bases --flank 11 --K 19 --mindepth 2 --minmq 30 --minqual 28	mutated	12	6	3	0	21
Pilon	--fix bases --flank 19 --K 73 --mindepth 0.71 --minmq 6 --minqual 2	random	16	10	6	5	37
Pilon	--fix all --flank 11 --K 19 --mindepth 3 --minmq 30 --minqual 28	mutated	12	7	1934	1560	3513
Pilon	--fix all --flank 1 --K 55 --mindepth 0.94 --minmq 44 --minqual 25 --nostrays	random	14	10	11	150	185
Pilon	--fix bases --flank 11 --K 19 --mindepth 2 --minmq 30 --minqual 33	mutated	12	6	3	0	21
Pilon	--fix bases --flank 9 --K 27 --mindepth 8 --minmq 29 --minqual 13	random	17	13	6	4	40
Pilon	--fix bases --flank 11 --K 21 --mindepth 2 --minmq 30 --minqual 33	mutated	12	6	3	0	21
Pilon	--fix all --flank 1 --K 27 --mindepth 2 --minmq 4 --minqual 36 --nostrays	random	17	18	17	17	69
Pilon	--fix bases --flank 13 --K 21 --mindepth 2 --minmq 30 --minqual 33	mutated	14	6	3	0	23
Pilon	--fix all --flank 2 --K 37 --mindepth 1 --minmq 44 --minqual 8	random	510	28	11	143	692
Pilon	--fix bases --flank 0 --K 77 --mindepth 4 --minmq 13 --minqual 21	random	12	7	3	0	22
Pilon	--fix bases --flank 10 --K 21 --mindepth 2 --minmq 30 --minqual 38	mutated	17	18	17	17	69
Pilon	--fix bases --flank 12 --K 51 --mindepth 4 --minmq 56 --minqual 28 --nostrays	random	16	8	3	1	28
Pilon	--fix bases --flank 11 --K 21 --mindepth 1 --minmq 30 --minqual 33	mutated	47	15	7	0	69
Pilon	--fix bases --flank 6 --K 57 --mindepth 0.47 --minmq 51 --minqual 12	random	14	8	3	3	28
Pilon	--fix bases --flank 3 --K 27 --mindepth 9 --minmq 46 --minqual 18 --nostrays	random	17	13	7	4	41
Pilon	--fix bases --flank 10 --K 21 --mindepth 2 --minmq 30 --minqual 33	mutated	13	6	3	0	22
Pilon	--fix all --flank 9 --K 53 --mindepth 0.86 --minmq 37 --minqual 35 --nostrays	random	17	18	18	18	71
Pilon	--fix bases --flank 11 --K 21 --mindepth 3 --minmq 30 --minqual 33	mutated	12	7	3	0	22
Pilon	--fix bases --flank 7 --K 23 --mindepth 0.1 --minmq 40 --minqual 33 --nostrays	random	14	8	3	1	26
Pilon	--fix bases --flank 11 --K 19 --mindepth 1 --minmq 30 --minqual 33	mutated	47	15	7	0	69
Pilon	--fix all --flank 8 --K 89 --mindepth 0.03 --minmq 43 --minqual 2	random	14	8	3	0	25
Pilon	--fix all --flank 11 --K 19 --mindepth 2 --minmq 30 --minqual 33	mutated	12	6	1934	1560	3512
Pilon	--fix all --flank 13 --K 87 --mindepth 0.65 --minmq 34 --minqual 12	random	16	9	6	4	35
Pilon	--fix bases --flank 15 --K 95 --mindepth 0.17 --minmq 54 --minqual 34	random	16	10	4	3	33
Pilon	--fix bases --flank 10 --K 21 --mindepth 1 --minmq 30 --minqual 33	mutated	46	15	7	0	68
Pilon	--fix bases --flank 9 --K 47 --mindepth 0.83 --minmq 44 --minqual 12 --nostrays	random	15	10	10	9	44
Pilon	--fix all --flank 11 --K 21 --mindepth 2 --minmq 30 --minqual 34	mutated	12	291	1934	996	3233
Pilon	--fix bases --flank 12 --K 35 --mindepth 9 --minmq 7 --minqual 13 --nostrays	random	18	13	11	4	46
Pilon	--fix bases --flank 11 --K 21 --mindepth 2 --minmq 27 --minqual 33	mutated	12	6	3	0	21
Pilon	--fix all --flank 5 --K 73 --mindepth 24 --minmq 35 --minqual 33	random	18	18	18	18	72
Pilon	--fix all --flank 11 --K 21 --mindepth 1 --minmq 27 --minqual 33	mutated	47	300	1938	996	3281
Pilon	--fix bases --flank 0 --K 95 --mindepth 14 --minmq 30 --minqual 21 --nostrays	random	18	17	11	9	55
Pilon	--fix bases --flank 14 --K 21 --mindepth 2 --minmq 27 --minqual 33	mutated	14	6	3	0	23
Pilon	--fix bases --flank 3 --K 81 --mindepth 11 --minmq 48 --minqual 3	random	17	13	8	7	45
Pilon	--fix bases --flank 9 --K 21 --mindepth 1 --minmq 32 --minqual 33	mutated	45	14	8	0	67
Pilon	--fix all --flank 10 --K 13 --mindepth 0.17 --minmq 7 --minqual 14 --nostrays	random	15	17254	12047	2607	31923
Pilon	--fix bases --flank 11 --K 21 --mindepth 1 --minmq 27 --minqual 33	mutated	47	15	7	0	69
Pilon	--fix bases --flank 10 --K 49 --mindepth 0.6 --minmq 5 --minqual 36	random	17	18	18	17	70
Pilon	--fix bases --flank 11 --K 21 --mindepth 3 --minmq 29 --minqual 33	mutated	12	7	3	0	22
Pilon	--fix all --flank 4 --K 83 --mindepth 3 --minmq 18 --minqual 34	random	11	7	3	0	21
Pilon	--fix all --flank 7 --K 83 --mindepth 3 --minmq 18 --minqual 34	mutated	11	7	3	0	21
Pilon	--fix all --flank 5 --K 55 --mindepth 0.9 --minmq 37 --minqual 22 --nostrays	random	14	10	13	149	186
Pilon	--fix all --flank 7 --K 83 --mindepth 3 --minmq 18 --minqual 37	mutated	17	18	17	17	69
Pilon	--fix bases --flank 10 --K 59 --mindepth 8 --minmq 22 --minqual 40	random	18	18	18	17	71
Pilon	--fix all --flank 7 --K 83 --mindepth 2 --minmq 18 --minqual 34	mutated	12	6	3	0	21
Pilon	--fix bases --flank 7 --K 85 --mindepth 0.92 --minmq 9 --minqual 11	random	14	12	10	11	47
Pilon	--fix all --flank 7 --K 83 --mindepth 2 --minmq 19 --minqual 39	mutated	17	18	17	17	69
Pilon	--fix bases --flank 14 --K 97 --mindepth 4 --minmq 9 --minqual 11 --nostrays	random	16	8	3	1	28
Pilon	--fix all --flank 9 --K 83 --mindepth 3 --minmq 18 --minqual 34	mutated	12	7	3	0	22
Pilon	--fix bases --flank 12 --K 35 --mindepth 24 --minmq 1 --minqual 15	random	18	18	18	18	72
Pilon	--fix all --flank 7 --K 85 --mindepth 3 --minmq 18 --minqual 34	mutated	11	7	3	0	21
Pilon	--fix all --flank 1 --K 69 --mindepth 0.1 --minmq 46 --minqual 5 --nostrays	random	14	8	3	138	163
Pilon	--fix bases --flank 7 --K 85 --mindepth 3 --minmq 18 --minqual 34	mutated	11	7	3	0	21
Pilon	--fix bases --flank 12 --K 15 --mindepth 10 --minmq 41 --minqual 31 --nostrays	random	18	16	12	5	51
Pilon	--fix all --flank 5 --K 85 --mindepth 3 --minmq 18 --minqual 34	mutated	11	7	3	0	21
Pilon	--fix all --flank 6 --K 85 --mindepth 3 --minmq 29 --minqual 36 --nostrays	random	17	18	17	17	69
Pilon	--fix bases --flank 2 --K 57 --mindepth 0.76 --minmq 57 --minqual 1 --nostrays	random	14	10	8	9	41
Pilon	--fix all --flank 5 --K 85 --mindepth 3 --minmq 18 --minqual 29	mutated	11	7	3	0	21
Pilon	--fix all --flank 20 --K 35 --mindepth 0.09 --minmq 39 --minqual 34 --nostrays	random	16	10	1167	3	1196
Pilon	--fix all --flank 5 --K 83 --mindepth 3 --minmq 18 --minqual 34	mutated	11	7	3	0	21
Pilon	--fix all --flank 3 --K 77 --mindepth 6 --minmq 60 --minqual 1	random	17	8	3	138	166
Pilon	--fix all --flank 5 --K 83 --mindepth 3 --minmq 14 --minqual 36	mutated	17	18	17	17	69
Pilon	--fix all --flank 18 --K 15 --mindepth 0.96 --minmq 23 --minqual 27 --nostrays	random	16	14	4509	3896	8435
Pilon	--fix all --flank 3 --K 83 --mindepth 3 --minmq 21 --minqual 34	mutated	10	6	3	0	19
Pilon	--fix bases --flank 17 --K 19 --mindepth 10 --minmq 32 --minqual 14	random	18	15	12	5	50
Pilon	--fix bases --flank 3 --K 85 --mindepth 3 --minmq 21 --minqual 34	mutated	10	6	3	0	19
Pilon	--fix bases --flank 2 --K 49 --mindepth 17 --minmq 28 --minqual 12 --nostrays	random	18	17	12	9	56
Pilon	--fix bases --flank 3 --K 85 --mindepth 4 --minmq 21 --minqual 34	mutated	13	7	3	0	23
Pilon	--fix all --flank 3 --K 53 --mindepth 0.91 --minmq 29 --minqual 31 --nostrays	random	14	11	13	149	187
Pilon	--fix bases --flank 17 --K 45 --mindepth 0.59 --minmq 18 --minqual 32 --nostrays	random	16	10	4	5	35
Pilon	--fix all --flank 6 --K 85 --mindepth 4 --minmq 21 --minqual 34	mutated	13	7	3	0	23
Pilon	--fix bases --flank 1 --K 19 --mindepth 15 --minmq 44 --minqual 20	random	18	17	13	9	57
Pilon	--fix bases --flank 3 --K 85 --mindepth 2 --minmq 21 --minqual 34	mutated	12	5	3	0	20
Pilon	--fix bases --flank 6 --K 39 --mindepth 0.68 --minmq 39 --minqual 13	random	14	9	9	8	40
Pilon	--fix all --flank 1 --K 85 --mindepth 0.95 --minmq 27 --minqual 11	random	14	10	10	10	44
Pilon	--fix bases --flank 3 --K 83 --mindepth 3 --minmq 11 --minqual 34	mutated	10	6	3	0	19
Pilon	--fix bases --flank 13 --K 55 --mindepth 0.64 --minmq 4 --minqual 38	random	18	18	18	17	71
Pilon	--fix bases --flank 3 --K 83 --mindepth 4 --minmq 11 --minqual 34	mutated	13	7	3	0	23
Pilon	--fix all --flank 15 --K 47 --mindepth 0.81 --minmq 41 --minqual 3 --nostrays	random	16	10	8	356	390
Pilon	--fix bases --flank 6 --K 21 --mindepth 10 --minmq 1 --minqual 25 --nostrays	random	17	13	9	5	44
Pilon	--fix all --flank 11 --K 83 --mindepth 18 --minmq 27 --minqual 37 --nostrays	random	18	18	18	18	72
Pilon	--fix bases --flank 3 --K 85 --mindepth 3 --minmq 11 --minqual 34	mutated	10	6	3	0	19
Pilon	--fix all --flank 14 --K 47 --mindepth 0.58 --minmq 55 --minqual 24 --nostrays	random	16	1825	4	351	2196
Pilon	--fix bases --flank 5 --K 85 --mindepth 3 --minmq 11 --minqual 34	mutated	11	7	3	0	21
Pilon	--fix bases --flank 14 --K 95 --mindepth 7 --minmq 11 --minqual 38	random	18	18	18	17	71
Pilon	--fix bases --flank 3 --K 87 --mindepth 3 --minmq 11 --minqual 34	mutated	10	6	3	0	19
Pilon	--fix all --flank 8 --K 11 --mindepth 1 --minmq 39 --minqual 17	random	23033	72590	11434	1916	108973
Pilon	--fix all --flank 5 --K 89 --mindepth 3 --minmq 11 --minqual 34	mutated	11	7	3	0	21
Pilon	--fix all --flank 17 --K 53 --mindepth 6 --minmq 1 --minqual 3 --nostrays	random	17	10	3	2	32
Pilon	--fix bases --flank 3 --K 85 --mindepth 4 --minmq 11 --minqual 36	mutated	17	18	17	17	69
Pilon	--fix bases --flank 9 --K 11 --mindepth 11 --minmq 55 --minqual 11	random	18	14	10	7	49
Pilon	--fix bases --flank 5 --K 87 --mindepth 3 --minmq 11 --minqual 34	mutated	11	7	3	0	21
Pilon	--fix bases --flank 17 --K 69 --mindepth 0.07 --minmq 37 --minqual 28	random	16	10	4	3	33
Pilon	--fix bases --flank 16 --K 21 --mindepth 0.93 --minmq 23 --minqual 7 --nostrays	random	16	10	11	11	48
Pilon	--fix bases --flank 4 --K 87 --mindepth 3 --minmq 11 --minqual 34	mutated	11	7	3	0	21
Pilon	--fix all --flank 4 --K 73 --mindepth 2 --minmq 58 --minqual 3 --nostrays	random	26	7	3	138	174
Pilon	--fix bases --flank 2 --K 81 --mindepth 9 --minmq 48 --minqual 25 --nostrays	random	17	13	7	4	41
Pilon	--fix bases --flank 3 --K 87 --mindepth 4 --minmq 11 --minqual 34	mutated	13	7	3	0	23
Pilon	--fix all --flank 7 --K 95 --mindepth 2 --minmq 28 --minqual 1	random	27	7	4	0	38
Pilon	--fix bases --flank 6 --K 87 --mindepth 4 --minmq 11 --minqual 34	mutated	13	7	3	0	23
Pilon	--fix all --flank 11 --K 15 --mindepth 3 --minmq 34 --minqual 12	random	18	4505	1418	787	6728
Pilon	--fix bases --flank 3 --K 19 --mindepth 7 --minmq 9 --minqual 9	random	17	10	3	0	30
Pilon	--fix all --flank 1 --K 77 --mindepth 20 --minmq 7 --minqual 16 --nostrays	random	18	18	15	13	64
Pilon	--fix all --flank 3 --K 87 --mindepth 2 --minmq 9 --minqual 34	mutated	12	5	3	0	20
Pilon	--fix all --flank 5 --K 55 --mindepth 18 --minmq 0 --minqual 30 --nostrays	random	18	18	15	151	202
Pilon	--fix bases --flank 3 --K 87 --mindepth 2 --minmq 11 --minqual 34	mutated	12	5	3	0	20
Pilon	--fix bases --flank 1 --K 91 --mindepth 3 --minmq 45 --minqual 24 --nostrays	random	10	6	3	0	19
Pilon	--fix bases --flank 1 --K 91 --mindepth 3 --minmq 38 --minqual 24	mutated	10	6	3	0	19
Pilon	--fix all --flank 5 --K 69 --mindepth 5 --minmq 56 --minqual 13 --nostrays	random	14	8	3	0	25
Pilon	--fix all --flank 6 --K 57 --mindepth 0.7 --minmq 28 --minqual 31 --nostrays	random	14	9	10	8	41
Pilon	--fix all --flank 3 --K 91 --mindepth 4 --minmq 40 --minqual 26	mutated	13	7	3	0	23
Pilon	--fix all --flank 19 --K 15 --mindepth 0.42 --minmq 30 --minqual 34 --nostrays	random	16	10	5845	3238	9109
Pilon	--fix bases --flank 1 --K 91 --mindepth 4 --minmq 38 --minqual 27	mutated	13	7	3	0	23
Pilon	--fix all --flank 4 --K 77 --mindepth 0.6 --minmq 7 --minqual 19	random	14	8	5	146	173
Pilon	--fix bases --flank 0 --K 89 --mindepth 3 --minmq 28 --minqual 24	mutated	10	6	3	0	19
Pilon	--fix all --flank 9 --K 29 --mindepth 6 --minmq 17 --minqual 39 --nostrays	random	18	18	17	17	70
Pilon	--fix bases --flank 3 --K 89 --mindepth 3 --minmq 28 --minqual 24	mutated	10	6	3	0	19
Pilon	--fix all --flank 1 --K 17 --mindepth 0.09 --minmq 21 --minqual 11 --nostrays	random	14	158	3	564	739
Pilon	--fix all --flank 1 --K 87 --mindepth 3 --minmq 28 --minqual 24	mutated	10	6	3	0	19
Pilon	--fix bases --flank 6 --K 51 --mindepth 0.82 --minmq 55 --minqual 26 --nostrays	random	14	11	11	10	46
Pilon	--fix bases --flank 4 --K 31 --mindepth 11 --minmq 38 --minqual 39 --nostrays	random	18	18	18	17	71
Pilon	--fix all --flank 7 --K 57 --mindepth 0.99 --minmq 2 --minqual 3	random	14	12	10	12	48
Pilon	--fix bases --flank 1 --K 57 --mindepth 17 --minmq 5 --minqual 39 --nostrays	random	18	18	18	18	72
Pilon	--fix all --flank 3 --K 87 --mindepth 4 --minmq 28 --minqual 24	mutated	13	7	3	0	23
Pilon	--fix all --flank 6 --K 93 --mindepth 0.21 --minmq 21 --minqual 15 --nostrays	random	14	8	3	0	25
Pilon	--fix all --flank 1 --K 87 --mindepth 3 --minmq 38 --minqual 24	mutated	10	6	3	0	19
Pilon	--fix all --flank 10 --K 61 --mindepth 0.15 --minmq 4 --minqual 1	random	15	8	3	0	26
Pilon	--fix all --flank 1 --K 87 --mindepth 3 --minmq 34 --minqual 24	mutated	10	6	3	0	19
Pilon	--fix all --flank 1 --K 47 --mindepth 0.28 --minmq 52 --minqual 16 --nostrays	random	14	8	3	138	163
Pilon	--fix all --flank 1 --K 87 --mindepth 3 --minmq 34 --minqual 19	mutated	10	6	3	0	19
Pilon	--fix bases --flank 9 --K 17 --mindepth 8 --minmq 50 --minqual 33	random	17	13	9	4	43
Pilon	--fix bases --flank 1 --K 87 --mindepth 3 --minmq 34 --minqual 19	mutated	10	6	3	0	19
Pilon	--fix bases --flank 12 --K 87 --mindepth 0.36 --minmq 17 --minqual 7	random	16	8	3	2	29
Pilon	--fix bases --flank 1 --K 87 --mindepth 3 --minmq 37 --minqual 19	mutated	10	6	3	0	19
Pilon	--fix bases --flank 9 --K 83 --mindepth 1 --minmq 48 --minqual 6 --nostrays	random	660	59	23	4	746
Pilon	--fix bases --flank 1 --K 87 --mindepth 4 --minmq 37 --minqual 19	mutated	13	7	3	0	23
Pilon	--fix all --flank 15 --K 33 --mindepth 4 --minmq 11 --minqual 10 --nostrays	random	16	8	3	347	374
Pilon	--fix bases --flank 1 --K 89 --mindepth 3 --minmq 37 --minqual 24	mutated	10	6	3	0	19
Pilon	--fix all --flank 3 --K 27 --mindepth 11 --minmq 35 --minqual 27	random	18	14	10	146	188
Pilon	--fix all --flank 9 --K 97 --mindepth 5 --minmq 47 --minqual 40	random	17	18	17	17	69
Pilon	--fix bases --flank 1 --K 89 --mindepth 3 --minmq 37 --minqual 25	mutated	10	6	3	0	19
Pilon	--fix all --flank 3 --K 41 --mindepth 25 --minmq 42 --minqual 6	random	18	18	17	16	69
Pilon	--fix all --flank 2 --K 89 --mindepth 3 --minmq 37 --minqual 25	mutated	10	6	3	0	19
Pilon	--fix bases --flank 12 --K 35 --mindepth 5 --minmq 54 --minqual 27	random	16	8	3	2	29
Pilon	--fix all --flank 2 --K 89 --mindepth 3 --minmq 39 --minqual 25	mutated	10	6	3	0	19
Pilon	--fix all --flank 11 --K 27 --mindepth 2 --minmq 47 --minqual 27	random	12	6	3	486	507
Pilon	--fix bases --flank 18 --K 87 --mindepth 19 --minmq 52 --minqual 12 --nostrays	random	18	18	16	16	68
Pilon	--fix all --flank 2 --K 87 --mindepth 3 --minmq 43 --minqual 25	mutated	10	6	3	0	19
Pilon	--fix bases --flank 7 --K 45 --mindepth 10 --minmq 36 --minqual 1 --nostrays	random	17	13	9	3	42
Pilon	--fix all --flank 2 --K 85 --mindepth 3 --minmq 43 --minqual 25	mutated	10	6	3	0	19
Pilon	--fix bases --flank 12 --K 85 --mindepth 2 --minmq 10 --minqual 2 --nostrays	random	32	7	3	0	42
Pilon	--fix all --flank 2 --K 85 --mindepth 4 --minmq 43 --minqual 25	mutated	13	7	3	0	23
Pilon	--fix all --flank 1 --K 45 --mindepth 0.65 --minmq 30 --minqual 26	random	14	1823	6	146	1989
Pilon	--fix all --flank 11 --K 49 --mindepth 0.26 --minmq 34 --minqual 7	random	15	8	3	347	373
Pilon	--fix all --flank 2 --K 35 --mindepth 0.12 --minmq 28 --minqual 26 --nostrays	random	14	1823	3	138	1978
Pilon	--fix all --flank 3 --K 93 --mindepth 2 --minmq 13 --minqual 14	random	13	5	3	138	159
Pilon	--fix all --flank 2 --K 85 --mindepth 3 --minmq 43 --minqual 26	mutated	10	6	3	0	19
Pilon	--fix all --flank 11 --K 51 --mindepth 10 --minmq 12 --minqual 5 --nostrays	random	17	14	10	4	45
Pilon	--fix all --flank 3 --K 85 --mindepth 3 --minmq 43 --minqual 26	mutated	10	6	3	0	19
Pilon	--fix all --flank 16 --K 39 --mindepth 27 --minmq 21 --minqual 36	random	18	18	18	18	72
Pilon	--fix all --flank 3 --K 83 --mindepth 4 --minmq 52 --minqual 26	mutated	13	7	3	0	23
Pilon	--fix all --flank 14 --K 53 --mindepth 2 --minmq 56 --minqual 36	random	18	18	17	17	70
Pilon	--fix all --flank 6 --K 61 --mindepth 9 --minmq 33 --minqual 31	random	17	13	10	5	45
Pilon	--fix bases --flank 5 --K 59 --mindepth 5 --minmq 0 --minqual 1	random	17	9	5	0	31
Pilon	--fix bases --flank 3 --K 85 --mindepth 3 --minmq 43 --minqual 28	mutated	10	6	3	1	20
Pilon	--fix all --flank 4 --K 17 --mindepth 9 --minmq 18 --minqual 36	random	18	18	18	17	71
Pilon	--fix all --flank 1 --K 87 --mindepth 3 --minmq 43 --minqual 26	mutated	10	6	3	0	19
Pilon	--fix all --flank 13 --K 35 --mindepth 0.82 --minmq 15 --minqual 34 --nostrays	random	16	13	1175	10	1214
Pilon	--fix all --flank 1 --K 87 --mindepth 2 --minmq 43 --minqual 26	mutated	12	5	3	0	20
Pilon	--fix bases --flank 14 --K 17 --mindepth 6 --minmq 18 --minqual 33	random	17	11	4	4	36
Pilon	--fix all --flank 15 --K 13 --mindepth 9 --minmq 13 --minqual 14 --nostrays	random	62060	28344	19704	3260	113368
Pilon	--fix all --flank 2 --K 89 --mindepth 3 --minmq 43 --minqual 24	mutated	10	6	3	0	19
Pilon	--fix bases --flank 8 --K 89 --mindepth 0.26 --minmq 23 --minqual 23 --nostrays	random	14	8	3	1	26
Pilon	--fix all --flank 5 --K 89 --mindepth 3 --minmq 43 --minqual 24	mutated	11	7	3	0	21
Pilon	--fix bases --flank 10 --K 91 --mindepth 7 --minmq 10 --minqual 22 --nostrays	random	17	13	5	2	37
Pilon	--fix bases --flank 5 --K 89 --mindepth 3 --minmq 43 --minqual 24	mutated	11	7	3	0	21
Pilon	--fix bases --flank 18 --K 59 --mindepth 1 --minmq 34 --minqual 38 --nostrays	random	18	18	17	17	70
Pilon	--fix all --flank 2 --K 89 --mindepth 3 --minmq 36 --minqual 28	mutated	10	6	3	0	19
Pilon	--fix all --flank 7 --K 37 --mindepth 0.55 --minmq 17 --minqual 23	random	14	1823	351	142	2330
Pilon	--fix all --flank 12 --K 15 --mindepth 0.57 --minmq 48 --minqual 1	random	16	5930	1420	790	8156
Pilon	--fix all --flank 2 --K 89 --mindepth 3 --minmq 37 --minqual 28	mutated	10	6	3	0	19
Pilon	--fix bases --flank 7 --K 85 --mindepth 0.18 --minmq 44 --minqual 4 --nostrays	random	14	8	3	0	25
Pilon	--fix bases --flank 2 --K 89 --mindepth 3 --minmq 37 --minqual 28	mutated	10	6	3	0	19
Pilon	--fix all --flank 11 --K 89 --mindepth 0.54 --minmq 15 --minqual 26	random	15	8	3	142	168
Pilon	--fix bases --flank 4 --K 89 --mindepth 3 --minmq 45 --minqual 28	mutated	11	7	3	1	22
Pilon	--fix all --flank 2 --K 45 --mindepth 13 --minmq 43 --minqual 9 --nostrays	random	17	16	10	9	52
Pilon	--fix bases --flank 2 --K 89 --mindepth 3 --minmq 35 --minqual 25	mutated	10	6	3	0	19
Pilon	--fix all --flank 12 --K 97 --mindepth 0.24 --minmq 26 --minqual 1 --nostrays	random	16	8	3	0	27
Pilon	--fix bases --flank 2 --K 91 --mindepth 3 --minmq 35 --minqual 25	mutated	10	6	3	0	19
Pilon	--fix bases --flank 17 --K 89 --mindepth 0.67 --minmq 10 --minqual 36	random	18	18	18	17	71
Pilon	--fix all --flank 8 --K 17 --mindepth 0.4 --minmq 5 --minqual 3	random	14	158	726	566	1464
Pilon	--fix bases --flank 14 --K 37 --mindepth 0.41 --minmq 3 --minqual 23 --nostrays	random	16	10	3	4	33
Pilon	--fix all --flank 10 --K 15 --mindepth 18 --minmq 58 --minqual 0 --nostrays	random	18	3988	1430	801	6237
Pilon	--fix bases --flank 2 --K 91 --mindepth 3 --minmq 26 --minqual 25	mutated	10	6	3	0	19
Pilon	--fix all --flank 18 --K 49 --mindepth 27 --minmq 7 --minqual 23 --nostrays	random	18	18	18	18	72
Pilon	--fix all --flank 7 --K 19 --mindepth 0.9 --minmq 18 --minqual 35	random	17	18	18	18	71
Pilon	--fix bases --flank 2 --K 89 --mindepth 2 --minmq 26 --minqual 25	mutated	13	5	3	0	21
Pilon	--fix bases --flank 0 --K 43 --mindepth 1 --minmq 55 --minqual 23 --nostrays	random	64	11	3	2	80
Pilon	--fix bases --flank 2 --K 91 --mindepth 4 --minmq 26 --minqual 25	mutated	13	7	3	0	23
Pilon	--fix bases --flank 1 --K 19 --mindepth 2 --minmq 24 --minqual 38 --nostrays	random	17	18	17	17	69
Pilon	--fix bases --flank 3 --K 91 --mindepth 3 --minmq 26 --minqual 21	mutated	10	6	3	0	19
Pilon	--fix bases --flank 7 --K 35 --mindepth 18 --minmq 48 --minqual 18	random	18	18	15	13	64
Pilon	--fix bases --flank 3 --K 93 --mindepth 3 --minmq 26 --minqual 21	mutated	10	6	3	0	19
Pilon	--fix all --flank 8 --K 63 --mindepth 3 --minmq 46 --minqual 5	random	19	7	3	138	167
Pilon	--fix bases --flank 6 --K 91 --mindepth 0.95 --minmq 53 --minqual 17	random	14	13	13	13	53
Pilon	--fix bases --flank 5 --K 93 --mindepth 3 --minmq 33 --minqual 21	mutated	11	7	3	0	21
Pilon	--fix bases --flank 2 --K 61 --mindepth 0.52 --minmq 43 --minqual 1 --nostrays	random	14	8	3	2	27
Pilon	--fix bases --flank 17 --K 65 --mindepth 14 --minmq 22 --minqual 26	random	18	18	13	14	63
Pilon	--fix bases --flank 6 --K 33 --mindepth 0.93 --minmq 32 --minqual 28 --nostrays	random	14	12	13	13	52
Pilon	--fix all --flank 3 --K 93 --mindepth 3 --minmq 36 --minqual 21	mutated	10	6	3	0	19
Pilon	--fix all --flank 1 --K 47 --mindepth 3 --minmq 48 --minqual 31	random	10	6	3	139	158
Pilon	--fix bases --flank 3 --K 93 --mindepth 3 --minmq 36 --minqual 21	mutated	10	6	3	0	19
Pilon	--fix bases --flank 13 --K 57 --mindepth 0.42 --minmq 39 --minqual 37 --nostrays	random	18	18	17	17	70
Pilon	--fix bases --flank 3 --K 93 --mindepth 3 --minmq 33 --minqual 21	mutated	10	6	3	0	19
Pilon	--fix all --flank 7 --K 59 --mindepth 0.74 --minmq 38 --minqual 12	random	14	10	9	9	42
Pilon	--fix all --flank 7 --K 85 --mindepth 2 --minmq 19 --minqual 17	random	13	6	3	0	22
Pilon	--fix bases --flank 3 --K 91 --mindepth 3 --minmq 33 --minqual 21	mutated	10	6	3	0	19
Pilon	--fix all --flank 0 --K 89 --mindepth 5 --minmq 37 --minqual 1	random	13	8	3	138	162
Pilon	--fix bases --flank 3 --K 91 --mindepth 4 --minmq 32 --minqual 21	mutated	13	7	3	0	23
Pilon	--fix all --flank 8 --K 43 --mindepth 0.18 --minmq 51 --minqual 25	random	14	1823	3	1	1841
Pilon	--fix bases --flank 3 --K 89 --mindepth 4 --minmq 33 --minqual 21	mutated	13	7	3	0	23
Pilon	--fix all --flank 8 --K 99 --mindepth 8 --minmq 15 --minqual 32 --nostrays	random	17	13	8	4	42
Pilon	--fix bases --flank 3 --K 91 --mindepth 3 --minmq 33 --minqual 24	mutated	10	6	3	0	19
Pilon	--fix bases --flank 5 --K 59 --mindepth 0.33 --minmq 9 --minqual 36 --nostrays	random	17	18	17	17	69
Pilon	--fix all --flank 3 --K 93 --mindepth 3 --minmq 43 --minqual 24	mutated	10	6	3	0	19
Pilon	--fix all --flank 1 --K 51 --mindepth 0.91 --minmq 25 --minqual 8	random	14	10	10	9	43
Pilon	--fix all --flank 3 --K 93 --mindepth 3 --minmq 34 --minqual 24	mutated	10	6	3	0	19
Pilon	--fix all --flank 4 --K 49 --mindepth 9 --minmq 18 --minqual 23 --nostrays	random	17	13	8	142	180
Pilon	--fix bases --flank 17 --K 77 --mindepth 0.52 --minmq 9 --minqual 15	random	16	10	4	4	34
Pilon	--fix all --flank 3 --K 93 --mindepth 2 --minmq 34 --minqual 24	mutated	13	5	3	0	21
Pilon	--fix all --flank 17 --K 77 --mindepth 0.54 --minmq 22 --minqual 33 --nostrays	random	16	10	4	5	35
Pilon	--fix bases --flank 3 --K 93 --mindepth 2 --minmq 34 --minqual 24	mutated	13	5	3	0	21
Pilon	--fix bases --flank 19 --K 23 --mindepth 0.04 --minmq 24 --minqual 17 --nostrays	random	16	10	3	2	31
Pilon	--fix all --flank 5 --K 93 --mindepth 3 --minmq 34 --minqual 24	mutated	11	7	3	0	21
Pilon	--fix bases --flank 15 --K 59 --mindepth 0.92 --minmq 56 --minqual 27	random	16	11	12	14	53
Pilon	--fix bases --flank 3 --K 93 --mindepth 3 --minmq 34 --minqual 24	mutated	10	6	3	0	19
Pilon	--fix bases --flank 8 --K 37 --mindepth 0.94 --minmq 37 --minqual 35 --nostrays	random	17	18	18	18	71
Pilon	--fix bases --flank 4 --K 93 --mindepth 3 --minmq 34 --minqual 24	mutated	11	7	3	0	21
Pilon	--fix bases --flank 5 --K 85 --mindepth 0.46 --minmq 47 --minqual 35	random	17	18	17	17	69
Pilon	--fix bases --flank 15 --K 33 --mindepth 7 --minmq 23 --minqual 36 --nostrays	random	18	18	18	17	71
Pilon	--fix all --flank 10 --K 33 --mindepth 0.29 --minmq 42 --minqual 1	random	15	8	3	485	511
Pilon	--fix bases --flank 3 --K 93 --mindepth 3 --minmq 34 --minqual 22	mutated	10	6	3	0	19
Pilon	--fix all --flank 17 --K 97 --mindepth 0.88 --minmq 2 --minqual 25 --nostrays	random	16	10	12	12	50
Pilon	--fix all --flank 2 --K 79 --mindepth 0.09 --minmq 21 --minqual 23	random	14	8	3	0	25
Pilon	--fix all --flank 5 --K 93 --mindepth 3 --minmq 32 --minqual 27	mutated	11	7	3	0	21
Pilon	--fix all --flank 19 --K 53 --mindepth 0.77 --minmq 49 --minqual 1 --nostrays	random	16	10	8	5	39
Pilon	--fix all --flank 3 --K 93 --mindepth 3 --minmq 34 --minqual 22	mutated	10	6	3	0	19
Pilon	--fix all --flank 4 --K 41 --mindepth 22 --minmq 5 --minqual 25	random	18	1833	17	153	2021
Pilon	--fix bases --flank 3 --K 95 --mindepth 4 --minmq 34 --minqual 22	mutated	13	7	3	0	23
Pilon	--fix bases --flank 6 --K 71 --mindepth 0.8 --minmq 54 --minqual 11	random	14	10	9	9	42
Pilon	--fix bases --flank 17 --K 51 --mindepth 0.25 --minmq 39 --minqual 17 --nostrays	random	16	10	3	2	31
Pilon	--fix bases --flank 13 --K 77 --mindepth 4 --minmq 58 --minqual 36 --nostrays	random	18	18	17	17	70
Pilon	--fix all --flank 17 --K 75 --mindepth 0.26 --minmq 54 --minqual 12 --nostrays	random	16	10	3	0	29
Pilon	--fix all --flank 3 --K 95 --mindepth 3 --minmq 34 --minqual 22	mutated	10	6	3	0	19
Pilon	--fix bases --flank 8 --K 25 --mindepth 0.71 --minmq 11 --minqual 25 --nostrays	random	14	9	9	8	40
Pilon	--fix all --flank 1 --K 95 --mindepth 3 --minmq 34 --minqual 26	mutated	10	6	3	0	19
Pilon	--fix all --flank 17 --K 11 --mindepth 0.17 --minmq 34 --minqual 17	random	16	126684	13705	947	141352
Pilon	--fix all --flank 1 --K 95 --mindepth 3 --minmq 40 --minqual 26	mutated	10	6	3	0	19
Pilon	--fix all --flank 14 --K 59 --mindepth 0.08 --minmq 22 --minqual 32	random	16	10	4	2	32
Pilon	--fix all --flank 1 --K 95 --mindepth 4 --minmq 33 --minqual 26	mutated	13	7	3	0	23
Pilon	--fix bases --flank 7 --K 57 --mindepth 0.92 --minmq 15 --minqual 17	random	14	12	13	13	52
Pilon	--fix all --flank 1 --K 93 --mindepth 3 --minmq 32 --minqual 26	mutated	10	6	3	0	19
Pilon	--fix bases --flank 10 --K 95 --mindepth 0.42 --minmq 45 --minqual 14	random	15	8	3	3	29
Pilon	--fix all --flank 1 --K 93 --mindepth 3 --minmq 34 --minqual 22	mutated	10	6	3	0	19
Pilon	--fix bases --flank 9 --K 49 --mindepth 0.95 --minmq 8 --minqual 6	random	15	13	10	10	48
Pilon	--fix all --flank 1 --K 93 --mindepth 2 --minmq 26 --minqual 22	mutated	12	5	3	0	20
Pilon	--fix all --flank 18 --K 47 --mindepth 0.36 --minmq 38 --minqual 38 --nostrays	random	18	18	17	17	70
Pilon	--fix all --flank 0 --K 93 --mindepth 3 --minmq 43 --minqual 22	mutated	10	6	3	0	19
Pilon	--fix bases --flank 17 --K 29 --mindepth 1 --minmq 26 --minqual 26 --nostrays	random	104	23	10	1	138
Pilon	--fix all --flank 16 --K 41 --mindepth 2 --minmq 36 --minqual 30 --nostrays	random	14	6	3	1	24
Pilon	--fix bases --flank 20 --K 43 --mindepth 2 --minmq 15 --minqual 28 --nostrays	random	14	6	3	1	24
Pilon	--fix all --flank 0 --K 95 --mindepth 3 --minmq 43 --minqual 22	mutated	10	6	3	0	19
Pilon	--fix all --flank 1 --K 25 --mindepth 9 --minmq 34 --minqual 8 --nostrays	random	17	10	5	2	34
Pilon	--fix all --flank 0 --K 95 --mindepth 2 --minmq 44 --minqual 22	mutated	13	5	3	0	21
Pilon	--fix all --flank 8 --K 71 --mindepth 0.7 --minmq 20 --minqual 6	random	14	9	7	8	38
Pilon	--fix all --flank 0 --K 95 --mindepth 3 --minmq 45 --minqual 22	mutated	10	6	3	0	19
Pilon	--fix all --flank 4 --K 97 --mindepth 0.37 --minmq 46 --minqual 22	random	14	8	3	3	28
Pilon	--fix bases --flank 4 --K 67 --mindepth 13 --minmq 51 --minqual 3 --nostrays	random	18	16	10	9	53
Pilon	--fix all --flank 8 --K 71 --mindepth 0.08 --minmq 44 --minqual 28	random	14	8	3	2	27
Pilon	--fix bases --flank 18 --K 21 --mindepth 4 --minmq 9 --minqual 8	random	16	10	3	0	29
Pilon	--fix all --flank 0 --K 97 --mindepth 3 --minmq 45 --minqual 22	mutated	10	6	3	0	19
Pilon	--fix bases --flank 1 --K 21 --mindepth 2 --minmq 0 --minqual 35	random	17	18	17	17	69
Pilon	--fix all --flank 9 --K 13 --mindepth 0.54 --minmq 18 --minqual 24 --nostrays	random	15	15292	10627	2747	28681
Pilon	--fix all --flank 19 --K 43 --mindepth 23 --minmq 60 --minqual 5	random	18	1833	18	365	2234
Pilon	--fix all --flank 0 --K 97 --mindepth 3 --minmq 54 --minqual 22	mutated	10	6	3	0	19
Pilon	--fix all --flank 8 --K 51 --mindepth 0.55 --minmq 59 --minqual 20 --nostrays	random	14	8	5	4	31
Pilon	--fix all --flank 0 --K 97 --mindepth 2 --minmq 54 --minqual 22	mutated	13	5	3	0	21
Pilon	--fix bases --flank 9 --K 75 --mindepth 0.81 --minmq 32 --minqual 25 --nostrays	random	15	9	10	10	44
Pilon	--fix all --flank 5 --K 93 --mindepth 21 --minmq 19 --minqual 37 --nostrays	random	18	18	18	18	72
Pilon	--fix all --flank 0 --K 99 --mindepth 4 --minmq 57 --minqual 22	mutated	12	7	3	0	22
Pilon	--fix all --flank 15 --K 45 --mindepth 6 --minmq 29 --minqual 26 --nostrays	random	17	1825	4	3	1849
Pilon	--fix bases --flank 13 --K 45 --mindepth 4 --minmq 12 --minqual 5 --nostrays	random	16	8	3	1	28
Pilon	--fix all --flank 15 --K 97 --mindepth 8 --minmq 12 --minqual 32 --nostrays	random	18	14	10	5	47
Pilon	--fix bases --flank 15 --K 37 --mindepth 0.43 --minmq 30 --minqual 35	random	18	18	17	17	70
Pilon	--fix all --flank 0 --K 97 --mindepth 3 --minmq 54 --minqual 19	mutated	10	6	3	0	19
Pilon	--fix all --flank 15 --K 37 --mindepth 0.59 --minmq 53 --minqual 28	random	16	10	1167	5	1198
Pilon	--fix bases --flank 8 --K 13 --mindepth 0.38 --minmq 11 --minqual 1	random	14	8	3	2	27
Pilon	--fix all --flank 0 --K 97 --mindepth 2 --minmq 60 --minqual 19	mutated	13	5	3	0	21
Pilon	--fix bases --flank 14 --K 99 --mindepth 0.36 --minmq 9 --minqual 28 --nostrays	random	16	10	4	2	32
Pilon	--fix all --flank 0 --K 97 --mindepth 2 --minmq 54 --minqual 19	mutated	13	5	3	0	21
Pilon	--fix bases --flank 3 --K 79 --mindepth 1 --minmq 21 --minqual 19 --nostrays	random	67	12	6	2	87
Pilon	--fix all --flank 0 --K 97 --mindepth 4 --minmq 49 --minqual 19	mutated	12	7	3	0	22
Pilon	--fix bases --flank 1 --K 95 --mindepth 0.26 --minmq 38 --minqual 4	random	14	8	3	0	25
Pilon	--fix all --flank 0 --K 95 --mindepth 3 --minmq 54 --minqual 19	mutated	10	6	3	0	19
Pilon	--fix all --flank 20 --K 63 --mindepth 0.49 --minmq 49 --minqual 38	random	18	18	17	17	70
Pilon	--fix all --flank 0 --K 95 --mindepth 3 --minmq 50 --minqual 19	mutated	10	6	3	0	19
Pilon	--fix bases --flank 1 --K 51 --mindepth 0.75 --minmq 6 --minqual 12	random	14	10	8	9	41
Pilon	--fix all --flank 3 --K 93 --mindepth 2 --minmq 50 --minqual 19	mutated	13	5	3	0	21
Pilon	--fix bases --flank 8 --K 79 --mindepth 1 --minmq 22 --minqual 31 --nostrays	random	46	14	8	0	68
Pilon	--fix all --flank 0 --K 95 --mindepth 4 --minmq 50 --minqual 15	mutated	12	7	3	0	22
Pilon	--fix bases --flank 19 --K 11 --mindepth 0.6 --minmq 24 --minqual 9 --nostrays	random	16	10	3	4	33
Pilon	--fix all --flank 0 --K 97 --mindepth 3 --minmq 50 --minqual 19	mutated	10	6	3	0	19
Pilon	--fix bases --flank 12 --K 17 --mindepth 2 --minmq 57 --minqual 16	random	15	6	3	0	24
Pilon	--fix all --flank 0 --K 99 --mindepth 3 --minmq 50 --minqual 20	mutated	10	6	3	0	19
Pilon	--fix all --flank 15 --K 27 --mindepth 15 --minmq 54 --minqual 2	random	18	18	360	360	756
Pilon	--fix bases --flank 0 --K 99 --mindepth 2 --minmq 50 --minqual 22	mutated	13	5	3	0	21
Pilon	--fix bases --flank 8 --K 37 --mindepth 0.25 --minmq 32 --minqual 6 --nostrays	random	14	8	3	0	25
Pilon	--fix all --flank 3 --K 99 --mindepth 3 --minmq 52 --minqual 20	mutated	10	6	3	0	19
Pilon	--fix all --flank 14 --K 99 --mindepth 0.28 --minmq 35 --minqual 31	random	16	10	4	2	32
Pilon	--fix all --flank 3 --K 99 --mindepth 3 --minmq 52 --minqual 24	mutated	10	6	3	0	19
Pilon	--fix all --flank 13 --K 49 --mindepth 6 --minmq 45 --minqual 9 --nostrays	random	17	10	3	349	379
Pilon	--fix all --flank 3 --K 99 --mindepth 3 --minmq 52 --minqual 27	mutated	10	6	3	1	20
Pilon	--fix bases --flank 9 --K 25 --mindepth 0.71 --minmq 19 --minqual 8	random	15	9	7	7	38
Pilon	--fix all --flank 1 --K 99 --mindepth 4 --minmq 52 --minqual 24	mutated	13	7	3	0	23
Pilon	--fix all --flank 10 --K 55 --mindepth 0.26 --minmq 7 --minqual 31 --nostrays	random	15	8	3	1	27
Pilon	--fix all --flank 6 --K 99 --mindepth 3 --minmq 52 --minqual 24	mutated	11	7	3	0	21
Pilon	--fix all --flank 16 --K 43 --mindepth 0.6 --minmq 24 --minqual 19	random	16	1825	6	5	1852
Pilon	--fix all --flank 5 --K 97 --mindepth 4 --minmq 52 --minqual 24	mutated	13	7	3	0	23
Pilon	--fix all --flank 17 --K 79 --mindepth 0.78 --minmq 15 --minqual 38	random	18	18	18	17	71
Pilon	--fix all --flank 3 --K 99 --mindepth 3 --minmq 58 --minqual 26	mutated	10	6	3	0	19
Pilon	--fix bases --flank 1 --K 37 --mindepth 0.42 --minmq 1 --minqual 30	random	14	8	4	2	28
Pilon	--fix all --flank 3 --K 99 --mindepth 3 --minmq 52 --minqual 26	mutated	10	6	3	0	19
Pilon	--fix bases --flank 16 --K 55 --mindepth 0.32 --minmq 6 --minqual 10	random	16	10	3	0	29
Pilon	--fix all --flank 2 --K 99 --mindepth 3 --minmq 56 --minqual 26	mutated	10	6	3	0	19
Pilon	--fix bases --flank 13 --K 53 --mindepth 0.42 --minmq 12 --minqual 36	random	18	18	17	17	70
Pilon	--fix all --flank 0 --K 99 --mindepth 3 --minmq 56 --minqual 26	mutated	10	6	3	0	19
Pilon	--fix all --flank 4 --K 55 --mindepth 2 --minmq 54 --minqual 18 --nostrays	random	13	6	3	138	160
Pilon	--fix all --flank 0 --K 99 --mindepth 4 --minmq 53 --minqual 26	mutated	12	7	3	0	22
Pilon	--fix all --flank 9 --K 13 --mindepth 0.25 --minmq 4 --minqual 19 --nostrays	random	15	15292	10627	2744	28678
Pilon	--fix all --flank 0 --K 99 --mindepth 3 --minmq 56 --minqual 30	mutated	10	6	3	1	20
Pilon	--fix all --flank 8 --K 19 --mindepth 0.61 --minmq 4 --minqual 38	random	17	18	18	17	70
Pilon	--fix all --flank 12 --K 55 --mindepth 0.07 --minmq 32 --minqual 34 --nostrays	random	16	8	3	1	28
Pilon	--fix bases --flank 9 --K 77 --mindepth 3 --minmq 30 --minqual 7 --nostrays	random	19	7	3	0	29
Pilon	--fix bases --flank 0 --K 97 --mindepth 3 --minmq 56 --minqual 26	mutated	10	6	3	0	19
Pilon	--fix bases --flank 11 --K 51 --mindepth 0.12 --minmq 24 --minqual 10	random	15	8	3	0	26
Pilon	--fix all --flank 0 --K 95 --mindepth 3 --minmq 60 --minqual 26	mutated	10	6	3	0	19
Pilon	--fix all --flank 20 --K 51 --mindepth 0.63 --minmq 38 --minqual 14	random	16	10	5	5	36
Pilon	--fix bases --flank 0 --K 95 --mindepth 3 --minmq 60 --minqual 26	mutated	10	6	3	0	19
Pilon	--fix all --flank 0 --K 49 --mindepth 0.62 --minmq 19 --minqual 17	random	13	8	6	146	173
Pilon	--fix bases --flank 0 --K 95 --mindepth 4 --minmq 60 --minqual 31	mutated	12	7	3	1	23
Pilon	--fix bases --flank 12 --K 19 --mindepth 0.74 --minmq 22 --minqual 25 --nostrays	random	16	10	11	9	46
Pilon	--fix bases --flank 0 --K 95 --mindepth 3 --minmq 60 --minqual 25	mutated	10	6	3	0	19
Pilon	--fix bases --flank 2 --K 11 --mindepth 0.1 --minmq 53 --minqual 7	random	14	8	3	0	25
Pilon	--fix all --flank 20 --K 65 --mindepth 0.51 --minmq 12 --minqual 23	random	16	10	3	4	33
Pilon	--fix bases --flank 17 --K 19 --mindepth 17 --minmq 44 --minqual 6 --nostrays	random	18	18	14	15	65
Pilon	--fix bases --flank 3 --K 95 --mindepth 3 --minmq 60 --minqual 29	mutated	10	6	3	1	20
Pilon	--fix all --flank 6 --K 49 --mindepth 0.8 --minmq 42 --minqual 23	random	14	11	9	148	182
Pilon	--fix bases --flank 0 --K 97 --mindepth 3 --minmq 60 --minqual 22	mutated	10	6	3	0	19
Pilon	--fix all --flank 15 --K 93 --mindepth 9 --minmq 33 --minqual 32	random	18	14	12	5	49
Pilon	--fix all --flank 12 --K 89 --mindepth 23 --minmq 14 --minqual 11	random	18	18	16	17	69
Pilon	--fix bases --flank 0 --K 95 --mindepth 3 --minmq 60 --minqual 22	mutated	10	6	3	0	19
Pilon	--fix bases --flank 11 --K 87 --mindepth 0.09 --minmq 19 --minqual 35	random	17	18	17	17	69
Pilon	--fix bases --flank 13 --K 69 --mindepth 6 --minmq 15 --minqual 3	random	17	10	3	3	33
Pilon	--fix bases --flank 14 --K 55 --mindepth 0.56 --minmq 19 --minqual 9	random	16	10	3	4	33
Pilon	--fix bases --flank 0 --K 95 --mindepth 3 --minmq 50 --minqual 22	mutated	10	6	3	0	19
Pilon	--fix bases --flank 16 --K 93 --mindepth 4 --minmq 49 --minqual 24 --nostrays	random	16	9	3	1	29
Pilon	--fix bases --flank 0 --K 93 --mindepth 2 --minmq 50 --minqual 22	mutated	13	5	3	0	21
Pilon	--fix bases --flank 4 --K 77 --mindepth 17 --minmq 59 --minqual 34	random	18	18	14	11	61
Pilon	--fix bases --flank 0 --K 97 --mindepth 3 --minmq 50 --minqual 22	mutated	10	6	3	0	19
Pilon	--fix bases --flank 0 --K 33 --mindepth 12 --minmq 42 --minqual 26 --nostrays	random	17	16	11	8	52
Pilon	--fix all --flank 1 --K 99 --mindepth 3 --minmq 50 --minqual 24	mutated	10	6	3	0	19
Pilon	--fix bases --flank 14 --K 89 --mindepth 0.14 --minmq 58 --minqual 1 --nostrays	random	16	10	3	0	29
Pilon	--fix bases --flank 20 --K 49 --mindepth 3 --minmq 39 --minqual 19 --nostrays	random	13	8	3	0	24
Pilon	--fix all --flank 1 --K 99 --mindepth 2 --minmq 50 --minqual 24	mutated	12	5	3	0	20
Pilon	--fix all --flank 10 --K 83 --mindepth 0.06 --minmq 19 --minqual 28 --nostrays	random	15	8	3	1	27
Pilon	--fix all --flank 17 --K 73 --mindepth 13 --minmq 30 --minqual 24	random	18	17	13	12	60
Pilon	--fix all --flank 1 --K 99 --mindepth 2 --minmq 44 --minqual 24	mutated	12	5	3	0	20
Pilon	--fix bases --flank 15 --K 23 --mindepth 0.95 --minmq 8 --minqual 27	random	16	13	12	14	55
Pilon	--fix bases --flank 2 --K 19 --mindepth 6 --minmq 46 --minqual 15	random	17	8	3	0	28
Pilon	--fix all --flank 1 --K 99 --mindepth 4 --minmq 50 --minqual 24	mutated	13	7	3	0	23
Pilon	--fix bases --flank 20 --K 47 --mindepth 14 --minmq 51 --minqual 34	random	18	18	14	15	65
Pilon	--fix bases --flank 1 --K 99 --mindepth 3 --minmq 50 --minqual 24	mutated	10	6	3	0	19
Pilon	--fix bases --flank 18 --K 13 --mindepth 22 --minmq 23 --minqual 12	random	18	18	18	18	72
Pilon	--fix bases --flank 3 --K 99 --mindepth 3 --minmq 50 --minqual 25	mutated	10	6	3	0	19
Pilon	--fix all --flank 5 --K 31 --mindepth 0.8 --minmq 33 --minqual 0 --nostrays	random	14	10	9	9	42
Pilon	--fix bases --flank 3 --K 99 --mindepth 4 --minmq 50 --minqual 25	mutated	13	7	3	0	23
Pilon	--fix bases --flank 11 --K 95 --mindepth 0.53 --minmq 51 --minqual 19 --nostrays	random	15	8	3	4	30
Pilon	--fix bases --flank 3 --K 99 --mindepth 3 --minmq 48 --minqual 25	mutated	10	6	3	0	19
Pilon	--fix bases --flank 4 --K 81 --mindepth 0.74 --minmq 9 --minqual 22	random	14	10	8	9	41
Pilon	--fix bases --flank 3 --K 99 --mindepth 3 --minmq 48 --minqual 29	mutated	10	6	3	1	20
Pilon	--fix bases --flank 15 --K 81 --mindepth 6 --minmq 45 --minqual 37	random	18	18	17	17	70
Pilon	--fix bases --flank 13 --K 85 --mindepth 0.25 --minmq 24 --minqual 7 --nostrays	random	16	9	3	1	29
Pilon	--fix bases --flank 3 --K 99 --mindepth 2 --minmq 47 --minqual 25	mutated	13	5	3	0	21
Pilon	--fix all --flank 2 --K 93 --mindepth 0.74 --minmq 23 --minqual 35	random	17	18	18	18	71
Pilon	--fix bases --flank 3 --K 99 --mindepth 3 --minmq 44 --minqual 25	mutated	10	6	3	0	19
Pilon	--fix all --flank 13 --K 61 --mindepth 0.95 --minmq 28 --minqual 30	random	16	13	12	11	52
Pilon	--fix bases --flank 3 --K 99 --mindepth 4 --minmq 44 --minqual 22	mutated	13	7	3	0	23
Pilon	--fix bases --flank 4 --K 43 --mindepth 0.4 --minmq 1 --minqual 27 --nostrays	random	14	8	3	4	29
Pilon	--fix bases --flank 4 --K 99 --mindepth 2 --minmq 54 --minqual 25	mutated	13	6	3	0	22
Pilon	--fix bases --flank 7 --K 79 --mindepth 1 --minmq 54 --minqual 15	random	75	20	4	1	100
Pilon	--fix bases --flank 3 --K 99 --mindepth 3 --minmq 41 --minqual 25	mutated	10	6	3	0	19
Pilon	--fix all --flank 5 --K 23 --mindepth 17 --minmq 48 --minqual 32 --nostrays	random	18	18	14	11	61
Pilon	--fix bases --flank 3 --K 99 --mindepth 3 --minmq 51 --minqual 21	mutated	10	6	3	0	19
Pilon	--fix all --flank 18 --K 49 --mindepth 0.19 --minmq 5 --minqual 21	random	16	10	3	2	31
Pilon	--fix all --flank 3 --K 99 --mindepth 2 --minmq 50 --minqual 21	mutated	13	5	3	0	21
Pilon	--fix bases --flank 20 --K 93 --mindepth 0.38 --minmq 1 --minqual 18	random	16	10	3	2	31
Pilon	--fix all --flank 3 --K 99 --mindepth 4 --minmq 54 --minqual 21	mutated	13	7	3	0	23
Pilon	--fix bases --flank 0 --K 29 --mindepth 0.29 --minmq 7 --minqual 0 --nostrays	random	13	8	3	0	24
Pilon	--fix bases --flank 10 --K 15 --mindepth 0.86 --minmq 15 --minqual 25 --nostrays	random	15	13	10	10	48
Pilon	--fix bases --flank 6 --K 99 --mindepth 3 --minmq 51 --minqual 21	mutated	11	7	3	0	21
Pilon	--fix bases --flank 17 --K 19 --mindepth 0.38 --minmq 46 --minqual 32	random	16	10	4	3	33
Pilon	--fix bases --flank 3 --K 97 --mindepth 3 --minmq 51 --minqual 19	mutated	10	6	3	0	19
Pilon	--fix bases --flank 5 --K 31 --mindepth 26 --minmq 25 --minqual 39 --nostrays	random	18	18	18	18	72
Pilon	--fix bases --flank 3 --K 97 --mindepth 3 --minmq 54 --minqual 19	mutated	10	6	3	0	19
Pilon	--fix all --flank 3 --K 75 --mindepth 19 --minmq 27 --minqual 24	random	18	18	15	151	202
Pilon	--fix bases --flank 1 --K 97 --mindepth 3 --minmq 54 --minqual 24	mutated	10	6	3	0	19
Pilon	--fix bases --flank 18 --K 75 --mindepth 17 --minmq 4 --minqual 5 --nostrays	random	18	18	14	15	65
Pilon	--fix bases --flank 7 --K 89 --mindepth 2 --minmq 60 --minqual 20	random	13	6	3	0	22
Pilon	--fix all --flank 1 --K 95 --mindepth 2 --minmq 54 --minqual 24	mutated	12	5	3	0	20
Pilon	--fix all --flank 5 --K 11 --mindepth 0.19 --minmq 54 --minqual 20	random	39560	60161	12739	1764	114224
Pilon	--fix bases --flank 1 --K 95 --mindepth 3 --minmq 54 --minqual 21	mutated	10	6	3	0	19
Pilon	--fix bases --flank 1 --K 55 --mindepth 5 --minmq 26 --minqual 21	random	14	8	3	0	25
Pilon	--fix bases --flank 13 --K 37 --mindepth 0.45 --minmq 33 --minqual 7	random	16	9	3	3	31
Pilon	--fix bases --flank 2 --K 95 --mindepth 2 --minmq 54 --minqual 21	mutated	13	5	3	0	21
Pilon	--fix all --flank 13 --K 87 --mindepth 9 --minmq 50 --minqual 0	random	17	13	9	3	42
Pilon	--fix all --flank 1 --K 95 --mindepth 3 --minmq 54 --minqual 21	mutated	10	6	3	0	19
Pilon	--fix bases --flank 16 --K 79 --mindepth 0.81 --minmq 51 --minqual 35 --nostrays	random	18	18	18	17	71
Pilon	--fix all --flank 20 --K 57 --mindepth 2 --minmq 40 --minqual 10 --nostrays	random	37	8	4	0	49
Pilon	--fix all --flank 1 --K 95 --mindepth 2 --minmq 54 --minqual 16	mutated	12	5	3	0	20
Pilon	--fix all --flank 1 --K 35 --mindepth 0.09 --minmq 24 --minqual 24 --nostrays	random	14	1823	3	138	1978
Pilon	--fix bases --flank 3 --K 47 --mindepth 3 --minmq 60 --minqual 25 --nostrays	random	10	6	3	0	19
Pilon	--fix bases --flank 3 --K 49 --mindepth 3 --minmq 58 --minqual 25	mutated	10	6	3	0	19
Pilon	--fix all --flank 19 --K 31 --mindepth 2 --minmq 53 --minqual 37	random	18	18	17	17	70
Pilon	--fix all --flank 3 --K 51 --mindepth 3 --minmq 58 --minqual 25	mutated	10	6	3	138	157
Pilon	--fix all --flank 1 --K 53 --mindepth 0.34 --minmq 40 --minqual 18	random	14	8	3	138	163
Pilon	--fix bases --flank 3 --K 49 --mindepth 3 --minmq 58 --minqual 30	mutated	10	6	3	1	20
Pilon	--fix all --flank 2 --K 73 --mindepth 0.27 --minmq 17 --minqual 38 --nostrays	random	17	18	17	17	69
Pilon	--fix bases --flank 3 --K 51 --mindepth 3 --minmq 58 --minqual 25	mutated	10	6	3	0	19
Pilon	--fix bases --flank 1 --K 65 --mindepth 0.21 --minmq 54 --minqual 9	random	14	8	3	0	25
Pilon	--fix all --flank 3 --K 49 --mindepth 4 --minmq 58 --minqual 25	mutated	13	7	3	138	161
Pilon	--fix all --flank 14 --K 25 --mindepth 0.11 --minmq 19 --minqual 11 --nostrays	random	16	10	153	1	180
Pilon	--fix bases --flank 20 --K 23 --mindepth 5 --minmq 10 --minqual 17	random	16	10	3	2	31
Pilon	--fix bases --flank 5 --K 51 --mindepth 3 --minmq 50 --minqual 25	mutated	11	7	3	0	21
Pilon	--fix bases --flank 20 --K 61 --mindepth 24 --minmq 23 --minqual 0 --nostrays	random	18	18	18	18	72
Pilon	--fix bases --flank 3 --K 51 --mindepth 3 --minmq 58 --minqual 20	mutated	10	6	3	0	19
Pilon	--fix bases --flank 12 --K 55 --mindepth 7 --minmq 3 --minqual 28	random	17	13	8	4	42
Pilon	--fix bases --flank 16 --K 33 --mindepth 0.69 --minmq 8 --minqual 40	random	18	18	18	17	71
Pilon	--fix all --flank 1 --K 13 --mindepth 0.73 --minmq 50 --minqual 32	random	6000	13336	9987	3711	33034
Pilon	--fix bases --flank 6 --K 51 --mindepth 3 --minmq 58 --minqual 20	mutated	11	7	3	0	21
Pilon	--fix all --flank 19 --K 51 --mindepth 0.57 --minmq 13 --minqual 29 --nostrays	random	16	10	4	5	35
Pilon	--fix all --flank 2 --K 57 --mindepth 0.51 --minmq 26 --minqual 18	random	14	8	4	142	168
Pilon	--fix bases --flank 3 --K 51 --mindepth 3 --minmq 58 --minqual 15	mutated	10	6	3	0	19
Pilon	--fix all --flank 9 --K 49 --mindepth 0.98 --minmq 23 --minqual 21	random	15	13	13	498	539
Pilon	--fix bases --flank 0 --K 79 --mindepth 0.51 --minmq 35 --minqual 17	random	13	8	4	4	29
Pilon	--fix bases --flank 3 --K 51 --mindepth 4 --minmq 58 --minqual 14	mutated	13	7	3	0	23
Pilon	--fix bases --flank 10 --K 95 --mindepth 0.17 --minmq 35 --minqual 25	random	15	8	3	1	27
Pilon	--fix bases --flank 0 --K 49 --mindepth 2 --minmq 58 --minqual 15	mutated	13	5	3	0	21
Pilon	--fix all --flank 8 --K 25 --mindepth 0.16 --minmq 21 --minqual 25 --nostrays	random	14	1823	350	1	2188
Pilon	--fix bases --flank 3 --K 51 --mindepth 2 --minmq 60 --minqual 12	mutated	26	6	3	0	35
Pilon	--fix bases --flank 2 --K 99 --mindepth 3 --minmq 55 --minqual 25	random	10	6	3	0	19
Pilon	--fix bases --flank 2 --K 97 --mindepth 2 --minmq 55 --minqual 25	mutated	13	5	3	0	21
Pilon	--fix bases --flank 16 --K 41 --mindepth 5 --minmq 60 --minqual 16 --nostrays	random	16	10	3	2	31
Pilon	--fix bases --flank 12 --K 33 --mindepth 0.5 --minmq 51 --minqual 21	random	16	8	3	4	31
Pilon	--fix all --flank 6 --K 89 --mindepth 12 --minmq 56 --minqual 31 --nostrays	random	18	16	13	8	55
Pilon	--fix bases --flank 3 --K 99 --mindepth 3 --minmq 55 --minqual 25	mutated	10	6	3	0	19
Pilon	--fix bases --flank 1 --K 75 --mindepth 5 --minmq 7 --minqual 8 --nostrays	random	14	8	3	0	25
Pilon	--fix all --flank 13 --K 29 --mindepth 0.29 --minmq 11 --minqual 13 --nostrays	random	16	9	350	349	724
Pilon	--fix bases --flank 3 --K 99 --mindepth 3 --minmq 60 --minqual 25	mutated	10	6	3	0	19
Pilon	--fix bases --flank 13 --K 71 --mindepth 0.15 --minmq 42 --minqual 1 --nostrays	random	16	9	3	0	28
Pilon	--fix bases --flank 3 --K 99 --mindepth 4 --minmq 60 --minqual 30	mutated	13	7	3	1	24
Pilon	--fix bases --flank 8 --K 13 --mindepth 20 --minmq 46 --minqual 23	random	18	18	15	15	66
Pilon	--fix bases --flank 3 --K 99 --mindepth 4 --minmq 60 --minqual 25	mutated	13	7	3	0	23
Pilon	--fix all --flank 13 --K 45 --mindepth 18 --minmq 18 --minqual 15 --nostrays	random	18	18	15	362	413
Pilon	--fix all --flank 20 --K 45 --mindepth 0.64 --minmq 35 --minqual 37 --nostrays	random	18	18	17	17	70
Pilon	--fix bases --flank 1 --K 41 --mindepth 12 --minmq 14 --minqual 23 --nostrays	random	17	16	11	8	52
Pilon	--fix bases --flank 3 --K 99 --mindepth 3 --minmq 60 --minqual 21	mutated	10	6	3	0	19
Pilon	--fix all --flank 10 --K 45 --mindepth 0.59 --minmq 2 --minqual 18 --nostrays	random	15	1823	5	489	2332
Pilon	--fix bases --flank 3 --K 99 --mindepth 4 --minmq 60 --minqual 16	mutated	13	7	3	0	23
Pilon	--fix all --flank 4 --K 83 --mindepth 23 --minmq 26 --minqual 26	random	18	18	18	153	207
Pilon	--fix all --flank 20 --K 55 --mindepth 4 --minmq 49 --minqual 23 --nostrays	random	16	10	3	1	30
Pilon	--fix bases --flank 3 --K 99 --mindepth 2 --minmq 57 --minqual 26	mutated	13	5	3	0	21
Pilon	--fix bases --flank 14 --K 81 --mindepth 0.44 --minmq 1 --minqual 15	random	16	10	3	4	33
Pilon	--fix bases --flank 3 --K 99 --mindepth 4 --minmq 53 --minqual 21	mutated	13	7	3	0	23
Pilon	--fix all --flank 14 --K 31 --mindepth 9 --minmq 15 --minqual 20	random	18	1828	359	351	2556
Pilon	--fix bases --flank 3 --K 97 --mindepth 4 --minmq 60 --minqual 21	mutated	13	7	3	0	23
Pilon	--fix all --flank 19 --K 93 --mindepth 0.31 --minmq 34 --minqual 12 --nostrays	random	16	10	3	0	29
Pilon	--fix bases --flank 3 --K 97 --mindepth 3 --minmq 60 --minqual 23	mutated	10	6	3	0	19
Pilon	--fix bases --flank 11 --K 35 --mindepth 0.81 --minmq 33 --minqual 36 --nostrays	random	17	18	18	18	71
Pilon	--fix bases --flank 3 --K 95 --mindepth 3 --minmq 60 --minqual 23	mutated	10	6	3	0	19
Pilon	--fix bases --flank 20 --K 69 --mindepth 10 --minmq 7 --minqual 36 --nostrays	random	18	18	18	17	71
Pilon	--fix bases --flank 3 --K 95 --mindepth 3 --minmq 51 --minqual 23	mutated	10	6	3	0	19
Pilon	--fix all --flank 16 --K 61 --mindepth 0.5 --minmq 59 --minqual 32 --nostrays	random	16	10	4	5	35
Pilon	--fix all --flank 3 --K 95 --mindepth 3 --minmq 51 --minqual 26	mutated	10	6	3	0	19
Pilon	--fix all --flank 16 --K 85 --mindepth 0.94 --minmq 25 --minqual 0 --nostrays	random	16	10	11	11	48
Pilon	--fix bases --flank 3 --K 95 --mindepth 3 --minmq 51 --minqual 26	mutated	10	6	3	0	19
Pilon	--fix all --flank 6 --K 17 --mindepth 11 --minmq 47 --minqual 24 --nostrays	random	18	1830	161	572	2581
Pilon	--fix all --flank 19 --K 77 --mindepth 0.27 --minmq 7 --minqual 11 --nostrays	random	16	10	3	0	29
Pilon	--fix bases --flank 3 --K 97 --mindepth 2 --minmq 51 --minqual 28	mutated	12	5	3	1	21
Pilon	--fix all --flank 13 --K 19 --mindepth 1 --minmq 26 --minqual 32	random	51	13	1170	1560	2794
Pilon	--fix bases --flank 2 --K 95 --mindepth 3 --minmq 51 --minqual 26	mutated	10	6	3	0	19
Pilon	--fix bases --flank 0 --K 25 --mindepth 0.02 --minmq 26 --minqual 17 --nostrays	random	13	8	3	0	24
Pilon	--fix bases --flank 2 --K 95 --mindepth 3 --minmq 42 --minqual 26	mutated	10	6	3	0	19
Pilon	--fix all --flank 5 --K 35 --mindepth 0.53 --minmq 32 --minqual 3 --nostrays	random	14	8	3	3	28
Pilon	--fix bases --flank 0 --K 95 --mindepth 2 --minmq 42 --minqual 26	mutated	13	5	3	0	21
Pilon	--fix bases --flank 13 --K 83 --mindepth 0.82 --minmq 8 --minqual 16 --nostrays	random	16	13	12	10	51
Pilon	--fix bases --flank 2 --K 95 --mindepth 4 --minmq 51 --minqual 26	mutated	13	7	3	0	23
Pilon	--fix all --flank 13 --K 27 --mindepth 5 --minmq 3 --minqual 19	random	16	9	350	349	724
Pilon	--fix bases --flank 1 --K 95 --mindepth 4 --minmq 42 --minqual 26	mutated	13	7	3	0	23
Pilon	--fix bases --flank 10 --K 91 --mindepth 2 --minmq 3 --minqual 20	random	14	6	3	0	23
Pilon	--fix bases --flank 2 --K 95 --mindepth 4 --minmq 34 --minqual 26	mutated	13	7	3	0	23
Pilon	--fix bases --flank 2 --K 59 --mindepth 22 --minmq 35 --minqual 2	random	18	18	15	15	66
Pilon	--fix bases --flank 0 --K 95 --mindepth 3 --minmq 42 --minqual 26	mutated	10	6	3	0	19
Pilon	--fix bases --flank 16 --K 57 --mindepth 0.2 --minmq 48 --minqual 16 --nostrays	random	16	10	3	2	31
Pilon	--fix bases --flank 0 --K 97 --mindepth 3 --minmq 42 --minqual 26	mutated	10	6	3	0	19
Pilon	--fix all --flank 6 --K 71 --mindepth 15 --minmq 45 --minqual 40	random	18	18	18	18	72
Pilon	--fix bases --flank 0 --K 97 --mindepth 3 --minmq 38 --minqual 26	mutated	10	6	3	0	19
Pilon	--fix bases --flank 9 --K 53 --mindepth 1 --minmq 15 --minqual 33	random	45	14	8	0	67
Pilon	--fix bases --flank 3 --K 99 --mindepth 3 --minmq 38 --minqual 26	mutated	10	6	3	0	19
Pilon	--fix bases --flank 20 --K 45 --mindepth 2 --minmq 2 --minqual 10	random	37	8	4	0	49
Pilon	--fix bases --flank 6 --K 99 --mindepth 3 --minmq 38 --minqual 26	mutated	11	7	3	0	21
Pilon	--fix all --flank 7 --K 21 --mindepth 0.86 --minmq 55 --minqual 32	random	14	2113	163	358	2648
Pilon	--fix bases --flank 13 --K 89 --mindepth 0.95 --minmq 21 --minqual 28	random	16	13	12	11	52
Pilon	--fix all --flank 3 --K 99 --mindepth 2 --minmq 38 --minqual 26	mutated	13	5	3	0	21
Pilon	--fix bases --flank 6 --K 83 --mindepth 25 --minmq 5 --minqual 0	random	18	18	18	17	71
Pilon	--fix bases --flank 3 --K 99 --mindepth 3 --minmq 38 --minqual 25	mutated	10	6	3	0	19
Pilon	--fix all --flank 13 --K 43 --mindepth 15 --minmq 28 --minqual 7	random	18	18	13	358	407
Pilon	--fix bases --flank 5 --K 97 --mindepth 4 --minmq 38 --minqual 28	mutated	13	7	3	0	23
Pilon	--fix bases --flank 16 --K 45 --mindepth 15 --minmq 9 --minqual 32	random	18	18	14	15	65
Pilon	--fix bases --flank 4 --K 99 --mindepth 3 --minmq 38 --minqual 28	mutated	11	7	3	0	21
Pilon	--fix all --flank 3 --K 15 --mindepth 10 --minmq 30 --minqual 9 --nostrays	random	1143	3327	927	870	6267
Pilon	--fix bases --flank 3 --K 99 --mindepth 3 --minmq 38 --minqual 22	mutated	10	6	3	0	19
Pilon	--fix bases --flank 3 --K 21 --mindepth 25 --minmq 29 --minqual 13 --nostrays	random	18	18	18	16	70
Pilon	--fix bases --flank 3 --K 99 --mindepth 4 --minmq 38 --minqual 25	mutated	13	7	3	0	23
Pilon	--fix all --flank 11 --K 79 --mindepth 0.23 --minmq 20 --minqual 36 --nostrays	random	17	18	17	17	69
Pilon	--fix bases --flank 9 --K 19 --mindepth 3 --minmq 17 --minqual 30	random	12	7	3	0	22
Pilon	--fix bases --flank 3 --K 99 --mindepth 3 --minmq 32 --minqual 17	mutated	10	6	3	0	19
Pilon	--fix bases --flank 16 --K 29 --mindepth 0.37 --minmq 44 --minqual 24	random	16	10	3	2	31
Pilon	--fix bases --flank 6 --K 29 --mindepth 0.42 --minmq 46 --minqual 32	random	14	8	3	4	29
Pilon	--fix all --flank 3 --K 97 --mindepth 3 --minmq 42 --minqual 17	mutated	10	6	3	0	19
Pilon	--fix bases --flank 13 --K 75 --mindepth 0.83 --minmq 57 --minqual 8 --nostrays	random	16	10	9	9	44
Pilon	--fix all --flank 3 --K 97 --mindepth 3 --minmq 42 --minqual 12	mutated	17	6	3	138	164
Pilon	--fix bases --flank 4 --K 75 --mindepth 3 --minmq 54 --minqual 11 --nostrays	random	18	7	3	0	28
Pilon	--fix all --flank 3 --K 95 --mindepth 3 --minmq 33 --minqual 17	mutated	10	6	3	0	19
Pilon	--fix all --flank 14 --K 69 --mindepth 7 --minmq 20 --minqual 32	random	17	13	9	4	43
Pilon	--fix all --flank 3 --K 95 --mindepth 3 --minmq 29 --minqual 17	mutated	10	6	3	0	19
Pilon	--fix all --flank 10 --K 71 --mindepth 0.35 --minmq 55 --minqual 38	random	17	18	17	17	69
Pilon	--fix bases --flank 6 --K 93 --mindepth 4 --minmq 29 --minqual 17	mutated	13	7	3	0	23
Pilon	--fix bases --flank 2 --K 11 --mindepth 0.92 --minmq 35 --minqual 5	random	14	10	10	9	43
Pilon	--fix bases --flank 4 --K 95 --mindepth 3 --minmq 35 --minqual 17	mutated	11	7	3	0	21
Pilon	--fix all --flank 8 --K 99 --mindepth 0.15 --minmq 45 --minqual 13 --nostrays	random	14	8	3	1	26
Pilon	--fix all --flank 19 --K 71 --mindepth 0.44 --minmq 51 --minqual 19	random	16	10	3	3	32
Polypolish	-i 0.2 -v 0.5 -m 10 -d 5	defaults	14	8	5	4	31
Polypolish	-i 0.2 -v 0.5 -m 10 -d 5 --careful	careful mode	14	8	5	4	31
Polypolish	-i 0.03 -v 0.83 -m 19 -d 19 --careful	random	18	18	14	12	62
Polypolish	-i 0.2 -v 0.55 -m 10 -d 5	mutated	14	8	5	4	31
Polypolish	-i 0.55 -v 0.95 -m 17 -d 19	random	18	18	14	12	62
Polypolish	-i 0.2 -v 0.54 -m 10 -d 5	mutated	14	8	5	4	31
Polypolish	-i 0.4 -v 0.6 -m 11 -d 10 --careful	random	17	13	7	6	43
Polypolish	-i 0.27 -v 0.58 -m 10 -d 5	mutated	14	8	4	4	30
Polypolish	-i 0.36 -v 0.62 -m 15 -d 18 --careful	random	18	18	12	10	58
Polypolish	-i 0.19 -v 0.64 -m 11 -d 4	mutated	13	8	5	4	30
Polypolish	-i 0.41 -v 0.78 -m 8 -d 11	random	17	13	9	7	46
Polypolish	-i 0.29 -v 0.51 -m 1 -d 12 --careful	random	18	17	16	13	64
Polypolish	-i 0.19 -v 0.56 -m 11 -d 5	mutated	14	8	5	4	31
Polypolish	-i 0.47 -v 0.78 -m 20 -d 17	random	18	17	12	9	56
Polypolish	-i 0.19 -v 0.73 -m 11 -d 4	mutated	13	8	5	4	30
Polypolish	-i 0.21 -v 0.4 -m 18 -d 5	random	14	8	5	4	31
Polypolish	-i 0.58 -v 0.63 -m 9 -d 13	random	17	16	13	10	56
Polypolish	-i 0.19 -v 0.73 -m 11 -d 5 --careful	mutated	14	8	5	4	31
Polypolish	-i 0.31 -v 0.98 -m 16 -d 15 --careful	random	18	17	12	9	56
Polypolish	-i 0.22 -v 0.73 -m 11 -d 3	mutated	12	5	4	4	25
Polypolish	-i 0.55 -v 0.65 -m 15 -d 12 --careful	random	17	15	10	8	50
Polypolish	-i 0.22 -v 0.73 -m 12 -d 3	mutated	12	5	4	4	25
Polypolish	-i 0.19 -v 0.49 -m 17 -d 11	random	17	13	9	7	46
Polypolish	-i 0.17 -v 0.73 -m 12 -d 4 --careful	mutated	13	8	5	4	30
Polypolish	-i 0.4 -v 0.63 -m 13 -d 10 --careful	random	17	13	7	6	43
Polypolish	-i 0.25 -v 0.73 -m 12 -d 3	mutated	12	5	3	4	24
Polypolish	-i 0.09 -v 0.72 -m 5 -d 11	random	17	13	10	7	47
Polypolish	-i 0.25 -v 0.73 -m 12 -d 3 --careful	mutated	12	5	4	4	25
Polypolish	-i 0.27 -v 0.91 -m 3 -d 3	random	10	5	4	1	20
Polypolish	-i 0.27 -v 0.91 -m 2 -d 4 --careful	mutated	13	8	4	4	29
Polypolish	-i 0.22 -v 0.94 -m 6 -d 10 --careful	random	17	13	8	6	44
Polypolish	-i 0.27 -v 0.91 -m 4 -d 2	mutated	15	5	4	4	28
Polypolish	-i 0.58 -v 0.76 -m 18 -d 6 --careful	random	17	9	4	4	34
Polypolish	-i 0.27 -v 0.87 -m 3 -d 3	mutated	10	5	4	1	20
Polypolish	-i 0.09 -v 0.6 -m 16 -d 8 --careful	random	17	10	7	4	38
Polypolish	-i 0.25 -v 0.72 -m 2 -d 7 --careful	random	17	12	6	4	39
Polypolish	-i 0.27 -v 0.87 -m 3 -d 3 --careful	mutated	10	5	4	1	20
Polypolish	-i 0.25 -v 0.48 -m 19 -d 15 --careful	random	18	17	12	9	56
Polypolish	-i 0.38 -v 0.43 -m 19 -d 6 --careful	random	17	9	1	4	31
Polypolish	-i 0.27 -v 0.87 -m 3 -d 4	mutated	13	8	4	4	29
Polypolish	-i 0.39 -v 0.59 -m 12 -d 20	random	18	18	15	12	63
Polypolish	-i 0.27 -v 0.87 -m 4 -d 4 --careful	mutated	13	8	4	4	29
Polypolish	-i 0.54 -v 0.68 -m 1 -d 4 --careful	random	13	11	6	6	36
Polypolish	-i 0.27 -v 0.8 -m 3 -d 4	mutated	13	8	4	4	29
Polypolish	-i 0.36 -v 0.54 -m 10 -d 12	random	17	15	10	8	50
Polypolish	-i 0.27 -v 0.87 -m 2 -d 3	mutated	11	6	4	4	25
Polypolish	-i 0.34 -v 0.76 -m 17 -d 16 --careful	random	18	17	12	9	56
Polypolish	-i 0.13 -v 0.7 -m 20 -d 2	random	13	8	5	4	30
Polypolish	-i 0.27 -v 0.84 -m 4 -d 3	mutated	10	5	4	4	23
Polypolish	-i 0.18 -v 0.54 -m 2 -d 14 --careful	random	18	17	12	9	56
Polypolish	-i 0.18 -v 0.87 -m 3 -d 3 --careful	mutated	10	5	5	1	21
Polypolish	-i 0.14 -v 0.66 -m 13 -d 4	random	13	8	5	4	30
Polypolish	-i 0.35 -v 0.87 -m 2 -d 3 --careful	mutated	10	6	4	4	24
Polypolish	-i 0.68 -v 0.74 -m 19 -d 13 --careful	random	17	16	10	9	52
Polypolish	-i 0.34 -v 0.78 -m 9 -d 16 --careful	random	18	17	12	9	56
Polypolish	-i 0.33 -v 0.87 -m 4 -d 4 --careful	mutated	13	8	4	4	29
Polypolish	-i 0.43 -v 0.59 -m 6 -d 12	random	17	15	10	8	50
Polypolish	-i 0.34 -v 0.87 -m 3 -d 3	mutated	11	5	4	1	21
Polypolish	-i 0.27 -v 0.88 -m 15 -d 15	random	18	17	12	9	56
Polypolish	-i 0.27 -v 0.93 -m 3 -d 2 --careful	mutated	15	5	5	1	26
Polypolish	-i 0.27 -v 0.49 -m 2 -d 19	random	18	18	16	15	67
Polypolish	-i 0.26 -v 0.65 -m 6 -d 5	random	14	8	4	4	30
Polypolish	-i 0.27 -v 0.87 -m 3 -d 4 --careful	mutated	13	8	4	4	29
Polypolish	-i 0.21 -v 0.79 -m 4 -d 13 --careful	random	18	17	11	9	55
Polypolish	-i 0.32 -v 0.44 -m 5 -d 20 --careful	random	18	18	15	12	63
Polypolish	-i 0.29 -v 0.87 -m 2 -d 3 --careful	mutated	10	6	4	4	24
Polypolish	-i 0.22 -v 0.76 -m 12 -d 11	random	17	13	9	7	46
Polypolish	-i 0.42 -v 0.63 -m 15 -d 13	random	17	16	10	9	52
Polypolish	-i 0.27 -v 0.86 -m 3 -d 4 --careful	mutated	13	8	4	4	29
Polypolish	-i 0.38 -v 0.92 -m 13 -d 8 --careful	random	17	10	6	4	37
Polypolish	-i 0.18 -v 0.36 -m 16 -d 4 --careful	random	13	8	5	4	30
Polypolish	-i 0.61 -v 0.72 -m 1 -d 17	random	18	18	17	16	69
Polypolish	-i 0.27 -v 0.97 -m 2 -d 3	mutated	11	6	6	4	27
Polypolish	-i 0.67 -v 0.78 -m 11 -d 18 --careful	random	18	18	12	10	58
Polypolish	-i 0.26 -v 0.55 -m 10 -d 18 --careful	random	18	18	12	10	58
Polypolish	-i 0.27 -v 0.87 -m 4 -d 3	mutated	10	5	4	4	23
Polypolish	-i 0.29 -v 0.59 -m 8 -d 15	random	18	17	12	9	56
Polypolish	-i 0.03 -v 0.63 -m 2 -d 14 --careful	random	18	18	14	14	64
Polypolish	-i 0.45 -v 0.6 -m 13 -d 19	random	18	18	14	12	62
Polypolish	-i 0.27 -v 0.87 -m 3 -d 2 --careful	mutated	15	5	4	1	25
Polypolish	-i 0.16 -v 0.66 -m 13 -d 20 --careful	random	18	18	15	12	63
Polypolish	-i 0.27 -v 0.85 -m 2 -d 3 --careful	mutated	10	6	4	4	24
Polypolish	-i 0.6 -v 0.65 -m 4 -d 12	random	17	15	11	10	53
Polypolish	-i 0.39 -v 0.48 -m 8 -d 8 --careful	random	17	10	6	4	37
Polypolish	-i 0.27 -v 0.95 -m 4 -d 3	mutated	10	5	5	4	24
Polypolish	-i 0.26 -v 0.38 -m 9 -d 14 --careful	random	18	17	11	9	55
Polypolish	-i 0.52 -v 0.77 -m 1 -d 5	random	15	12	8	6	41
Polypolish	-i 0.27 -v 0.94 -m 2 -d 3 --careful	mutated	10	6	5	4	25
Polypolish	-i 0.19 -v 0.43 -m 12 -d 5	random	14	8	5	4	31
Polypolish	-i 0.24 -v 0.87 -m 2 -d 3 --careful	mutated	10	6	4	4	24
Polypolish	-i 0.29 -v 0.9 -m 4 -d 11 --careful	random	17	14	9	7	47
Polypolish	-i 0.24 -v 0.61 -m 4 -d 11 --careful	random	17	14	9	7	47
Polypolish	-i 0.21 -v 0.66 -m 14 -d 19 --careful	random	18	18	14	12	62
Polypolish	-i 0.34 -v 0.53 -m 20 -d 15	random	18	17	12	9	56
Polypolish	-i 0.21 -v 0.87 -m 3 -d 3 --careful	mutated	10	5	5	1	21
Polypolish	-i 0.18 -v 0.6 -m 14 -d 1	random	12	5	5	4	26
Polypolish	-i 0.27 -v 0.87 -m 4 -d 3 --careful	mutated	10	5	4	4	23
Polypolish	-i 0.11 -v 0.22 -m 19 -d 16 --careful	random	18	17	12	9	56
Polypolish	-i 0.63 -v 0.86 -m 4 -d 14	random	18	17	12	11	58
Polypolish	-i 0.01 -v 0.65 -m 20 -d 10 --careful	random	18	18	18	18	72
Polypolish	-i 0.45 -v 0.96 -m 18 -d 11 --careful	random	17	13	9	7	46
Polypolish	-i 0.46 -v 0.97 -m 16 -d 1	random	25	6	9	4	44
Polypolish	-i 0.27 -v 0.88 -m 3 -d 3	mutated	10	5	4	1	20
Polypolish	-i 0.48 -v 0.68 -m 20 -d 17 --careful	random	18	17	12	9	56
Polypolish	-i 0.27 -v 0.88 -m 3 -d 3 --careful	mutated	10	5	4	1	20
Polypolish	-i 0.69 -v 0.87 -m 19 -d 3	random	25	18	8	12	63
Polypolish	-i 0.21 -v 0.88 -m 3 -d 3	mutated	10	5	5	1	21
Polypolish	-i 0.05 -v 0.21 -m 1 -d 19 --careful	random	18	18	17	17	70
Polypolish	-i 0.11 -v 0.33 -m 15 -d 13 --careful	random	17	16	10	9	52
Polypolish	-i 0.34 -v 0.88 -m 3 -d 3	mutated	11	5	4	1	21
Polypolish	-i 0.76 -v 0.91 -m 19 -d 16 --careful	random	18	17	12	9	56
Polypolish	-i 0.31 -v 0.38 -m 12 -d 13	random	17	16	10	9	52
Polypolish	-i 0.27 -v 0.88 -m 2 -d 3 --careful	mutated	10	6	4	4	24
Polypolish	-i 0.54 -v 0.61 -m 12 -d 20	random	18	18	15	12	63
Polypolish	-i 0.48 -v 0.61 -m 11 -d 8 --careful	random	17	10	6	4	37
Polypolish	-i 0.27 -v 0.88 -m 4 -d 3 --careful	mutated	10	5	4	4	23
Polypolish	-i 0.61 -v 0.93 -m 6 -d 6	random	22	10	8	5	45
Polypolish	-i 0.27 -v 0.88 -m 2 -d 2	mutated	15	4	4	4	27
Polypolish	-i 0.13 -v 0.62 -m 18 -d 14 --careful	random	18	17	11	9	55
Polypolish	-i 0.07 -v 0.29 -m 0 -d 19 --careful	random	18	18	18	18	72
Polypolish	-i 0.27 -v 0.88 -m 2 -d 3	mutated	11	6	4	4	25
Polypolish	-i 0.22 -v 0.52 -m 11 -d 5 --careful	random	14	8	4	4	30
Polypolish	-i 0.27 -v 0.88 -m 3 -d 2	mutated	15	5	4	1	25
Polypolish	-i 0.2 -v 0.38 -m 17 -d 12	random	17	15	10	8	50
Polypolish	-i 0.27 -v 0.78 -m 3 -d 2 --careful	mutated	15	5	4	1	25
Polypolish	-i 0.15 -v 0.72 -m 11 -d 1	random	13	8	5	4	30
Polypolish	-i 0.3 -v 0.35 -m 18 -d 9 --careful	random	17	10	7	6	40
Polypolish	-i 0.27 -v 0.98 -m 2 -d 3	mutated	11	6	6	4	27
Polypolish	-i 0.31 -v 0.63 -m 17 -d 19	random	18	18	14	12	62
Polypolish	-i 0.25 -v 0.88 -m 16 -d 19	random	18	18	14	12	62
Polypolish	-i 0.2 -v 0.63 -m 18 -d 6 --careful	random	17	9	5	4	35
Polypolish	-i 0.26 -v 0.45 -m 0 -d 7 --careful	random	18	18	18	18	72
Polypolish	-i 0.27 -v 0.88 -m 3 -d 2 --careful	mutated	15	5	4	1	25
Polypolish	-i 0.43 -v 0.69 -m 17 -d 8	random	20	10	6	4	40
Polypolish	-i 0.46 -v 0.77 -m 15 -d 4	random	18	10	7	4	39
Polypolish	-i 0.33 -v 0.65 -m 5 -d 19	random	18	18	14	12	62
Polypolish	-i 0.27 -v 0.95 -m 3 -d 3 --careful	mutated	10	5	5	1	21
Polypolish	-i 0.31 -v 0.46 -m 20 -d 6	random	17	9	1	4	31
Polypolish	-i 0.13 -v 0.73 -m 0 -d 8	random	18	18	18	18	72
Polypolish	-i 0.27 -v 0.88 -m 4 -d 2 --careful	mutated	16	5	4	4	29
Polypolish	-i 0.48 -v 0.51 -m 1 -d 4	random	13	11	6	6	36
Polypolish	-i 0.63 -v 0.87 -m 6 -d 17	random	18	17	12	11	58
Polypolish	-i 0.27 -v 0.88 -m 4 -d 3	mutated	10	5	4	4	23
Polypolish	-i 0.27 -v 0.81 -m 0 -d 3	random	18	18	18	18	72
Polypolish	-i 0.02 -v 0.61 -m 0 -d 9 --careful	random	18	18	18	18	72
Polypolish	-i 0.27 -v 0.86 -m 3 -d 3 --careful	mutated	10	5	4	1	20
Polypolish	-i 0.79 -v 0.96 -m 9 -d 9 --careful	random	17	10	7	6	40
Polypolish	-i 0.31 -v 0.86 -m 3 -d 3 --careful	mutated	10	5	4	1	20
Polypolish	-i 0.14 -v 0.6 -m 5 -d 3 --careful	random	13	8	5	4	30
Polypolish	-i 0.37 -v 0.86 -m 3 -d 3 --careful	mutated	10	5	4	1	20
Polypolish	-i 0.23 -v 0.93 -m 4 -d 2 --careful	random	10	5	5	4	24
Polypolish	-i 0.37 -v 0.86 -m 3 -d 4 --careful	mutated	13	8	4	4	29
Polypolish	-i 0.39 -v 0.41 -m 3 -d 12	random	18	15	11	8	52
Polypolish	-i 0.5 -v 0.59 -m 14 -d 4 --careful	random	13	8	4	1	26
Polypolish	-i 0.14 -v 0.74 -m 14 -d 2 --careful	random	13	8	5	4	30
Polypolish	-i 0.38 -v 0.86 -m 3 -d 4 --careful	mutated	13	8	4	4	29
Polypolish	-i 0.15 -v 0.95 -m 17 -d 17 --careful	random	18	17	12	9	56
Polypolish	-i 0.37 -v 0.86 -m 3 -d 3	mutated	11	5	4	1	21
Polypolish	-i 0.47 -v 0.6 -m 12 -d 11 --careful	random	17	13	9	7	46
Polypolish	-i 0.34 -v 0.86 -m 3 -d 2 --careful	mutated	15	5	4	1	25
Polypolish	-i 0.56 -v 0.92 -m 20 -d 15 --careful	random	18	17	12	9	56
Polypolish	-i 0.37 -v 0.86 -m 4 -d 3	mutated	11	5	3	4	23
Polypolish	-i 0.21 -v 0.5 -m 4 -d 16	random	18	17	12	10	57
Polypolish	-i 0.37 -v 0.83 -m 3 -d 3	mutated	11	5	4	1	21
Polypolish	-i 0.03 -v 0.61 -m 3 -d 3 --careful	random	18	18	12	11	59
Polypolish	-i 0.42 -v 0.86 -m 3 -d 3 --careful	mutated	10	5	4	1	20
Polypolish	-i 0.49 -v 0.66 -m 19 -d 1 --careful	random	22	5	3	4	34
Polypolish	-i 0.42 -v 0.86 -m 3 -d 3	mutated	11	5	3	1	20
Polypolish	-i 0.02 -v 0.46 -m 4 -d 1	random	18	18	18	17	71
Polypolish	-i 0.33 -v 0.86 -m 3 -d 3	mutated	11	5	4	1	21
Polypolish	-i 0.17 -v 0.6 -m 18 -d 17	random	18	17	12	9	56
Polypolish	-i 0.46 -v 0.86 -m 2 -d 3 --careful	mutated	10	6	4	4	24
Polypolish	-i 0.33 -v 0.48 -m 1 -d 2	random	16	5	5	6	32
Polypolish	-i 0.42 -v 0.86 -m 4 -d 3 --careful	mutated	10	5	3	4	22
Polypolish	-i 0.49 -v 0.72 -m 20 -d 15	random	18	17	12	9	56
Polypolish	-i 0.27 -v 0.67 -m 2 -d 5 --careful	random	14	9	4	4	31
Polypolish	-i 0.09 -v 0.99 -m 3 -d 16	random	18	17	12	10	57
Polypolish	-i 0.42 -v 0.86 -m 2 -d 3 --careful	mutated	10	6	4	4	24
Polypolish	-i 0.2 -v 0.86 -m 13 -d 6 --careful	random	17	9	5	4	35
Polypolish	-i 0.25 -v 0.76 -m 20 -d 2	random	12	5	4	4	25
Polypolish	-i 0.4 -v 0.57 -m 7 -d 10 --careful	random	17	13	7	6	43
Polypolish	-i 0.34 -v 0.96 -m 4 -d 3	mutated	10	5	6	4	25
Polypolish	-i 0.66 -v 0.93 -m 16 -d 5	random	24	18	8	9	59
Polypolish	-i 0.42 -v 0.86 -m 3 -d 2 --careful	mutated	15	5	4	1	25
Polypolish	-i 0.24 -v 0.46 -m 9 -d 2	random	12	5	1	3	21
Polypolish	-i 0.63 -v 0.86 -m 4 -d 17	random	18	18	12	12	60
Polypolish	-i 0.25 -v 0.47 -m 1 -d 20	random	18	18	18	17	71
Polypolish	-i 0.42 -v 0.74 -m 0 -d 3 --careful	random	18	18	18	18	72
Polypolish	-i 0.35 -v 0.86 -m 3 -d 3 --careful	mutated	10	5	4	1	20
Polypolish	-i 0.0 -v 0.51 -m 6 -d 15	random	inf	inf	inf	inf	inf
Polypolish	-i 0.41 -v 0.86 -m 3 -d 2 --careful	mutated	15	5	4	1	25
Polypolish	-i 0.35 -v 0.89 -m 15 -d 2 --careful	random	21	5	4	4	34
Polypolish	-i 0.35 -v 0.76 -m 3 -d 3	mutated	11	5	4	1	21
Polypolish	-i 0.18 -v 0.68 -m 19 -d 8	random	17	10	6	4	37
Polypolish	-i 0.3 -v 0.72 -m 11 -d 20	random	18	18	15	12	63
Polypolish	-i 0.35 -v 0.86 -m 3 -d 2	mutated	16	5	4	1	26
Polypolish	-i 0.3 -v 0.38 -m 6 -d 19 --careful	random	18	18	14	12	62
Polypolish	-i 0.24 -v 0.96 -m 15 -d 1	random	12	5	5	4	26
Polypolish	-i 0.35 -v 0.82 -m 4 -d 3	mutated	11	5	3	4	23
Polypolish	-i 0.24 -v 0.28 -m 5 -d 6	random	17	9	4	4	34
Polypolish	-i 0.35 -v 0.89 -m 3 -d 3 --careful	mutated	10	5	4	1	20
Polypolish	-i 0.3 -v 0.34 -m 17 -d 20 --careful	random	18	18	15	12	63
Polypolish	-i 0.03 -v 0.3 -m 3 -d 5	random	18	18	12	11	59
Polypolish	-i 0.35 -v 0.89 -m 2 -d 3	mutated	11	6	4	4	25
Polypolish	-i 0.69 -v 0.72 -m 0 -d 2	random	18	18	18	18	72
Polypolish	-i 0.35 -v 0.89 -m 3 -d 3	mutated	11	5	4	1	21
Polypolish	-i 0.33 -v 0.74 -m 6 -d 5 --careful	random	14	8	4	4	30
Polypolish	-i 0.17 -v 0.58 -m 14 -d 7	random	17	10	5	4	36
Polypolish	-i 0.35 -v 0.87 -m 3 -d 2	mutated	16	5	4	1	26
Polypolish	-i 0.31 -v 0.53 -m 5 -d 19	random	18	18	14	12	62
Polypolish	-i 0.52 -v 0.68 -m 16 -d 3 --careful	random	14	5	3	1	23
Polypolish	-i 0.45 -v 0.89 -m 3 -d 2	mutated	16	5	4	1	26
Polypolish	-i 0.33 -v 0.53 -m 5 -d 2	random	15	3	3	3	24
Polypolish	-i 0.35 -v 0.89 -m 3 -d 2	mutated	16	5	4	1	26
Polypolish	-i 0.15 -v 0.68 -m 7 -d 12 --careful	random	17	15	10	8	50
Polypolish	-i 0.45 -v 0.89 -m 3 -d 3 --careful	mutated	10	5	4	1	20
Polypolish	-i 0.61 -v 0.81 -m 13 -d 5 --careful	random	14	8	4	4	30
Polypolish	-i 0.45 -v 0.89 -m 3 -d 2 --careful	mutated	15	5	4	1	25
Polypolish	-i 0.55 -v 0.73 -m 12 -d 10 --careful	random	17	13	7	6	43
Polypolish	-i 0.45 -v 0.99 -m 3 -d 3 --careful	mutated	10	5	6	1	22
Polypolish	-i 0.05 -v 0.38 -m 10 -d 6 --careful	random	17	13	10	7	47
Polypolish	-i 0.48 -v 0.89 -m 3 -d 3	mutated	11	5	4	1	21
Polypolish	-i 0.13 -v 0.37 -m 13 -d 5 --careful	random	14	8	5	4	31
Polypolish	-i 0.45 -v 0.89 -m 3 -d 3	mutated	11	5	4	1	21
Polypolish	-i 0.3 -v 0.69 -m 13 -d 7 --careful	random	17	10	5	4	36
Polypolish	-i 0.05 -v 0.92 -m 18 -d 19	random	18	18	14	12	62
Polypolish	-i 0.45 -v 0.89 -m 2 -d 3 --careful	mutated	10	6	4	4	24
Polypolish	-i 0.12 -v 0.73 -m 8 -d 1 --careful	random	14	8	5	4	31
Polypolish	-i 0.61 -v 0.66 -m 8 -d 2	random	57	11	7	2	77
Polypolish	-i 0.09 -v 0.64 -m 16 -d 1	random	17	9	6	4	36
Polypolish	-i 0.45 -v 0.89 -m 2 -d 4	mutated	13	8	4	4	29
Polypolish	-i 0.43 -v 0.48 -m 14 -d 17 --careful	random	18	17	12	9	56
Polypolish	-i 0.61 -v 0.91 -m 19 -d 5 --careful	random	14	8	4	4	30
Polypolish	-i 0.33 -v 0.66 -m 6 -d 8	random	17	10	6	4	37
Polypolish	-i 0.45 -v 0.89 -m 4 -d 3	mutated	11	5	3	4	23
Polypolish	-i 0.68 -v 0.86 -m 18 -d 14	random	18	17	14	17	66
Polypolish	-i 0.18 -v 0.51 -m 1 -d 12	random	18	17	16	13	64
Polypolish	-i 0.45 -v 0.81 -m 3 -d 3	mutated	11	5	3	1	20
Polypolish	-i 0.68 -v 1.0 -m 13 -d 14	random	inf	inf	inf	inf	inf
Polypolish	-i 0.45 -v 0.77 -m 2 -d 3 --careful	mutated	10	6	4	4	24
Polypolish	-i 0.22 -v 0.53 -m 20 -d 3 --careful	random	12	5	4	4	25
Polypolish	-i 0.45 -v 0.81 -m 3 -d 3 --careful	mutated	10	5	4	1	20
Polypolish	-i 0.46 -v 0.8 -m 15 -d 4	random	18	10	7	4	39
Polypolish	-i 0.45 -v 0.84 -m 3 -d 3	mutated	11	5	3	1	20
Polypolish	-i 0.54 -v 0.59 -m 9 -d 11	random	17	15	12	7	51
Polypolish	-i 0.31 -v 0.79 -m 19 -d 18	random	18	18	12	10	58
Polypolish	-i 0.54 -v 0.77 -m 3 -d 3	mutated	11	5	3	2	21
Polypolish	-i 0.01 -v 0.98 -m 8 -d 6	random	18	18	18	18	72
Polypolish	-i 0.41 -v 0.84 -m 3 -d 3	mutated	11	5	3	1	20
Polypolish	-i 0.38 -v 0.88 -m 0 -d 11 --careful	random	18	18	18	18	72
Polypolish	-i 0.44 -v 0.84 -m 3 -d 3 --careful	mutated	10	5	4	1	20
Polypolish	-i 0.08 -v 0.79 -m 19 -d 9 --careful	random	17	10	8	6	41
Polypolish	-i 0.44 -v 0.8 -m 3 -d 3	mutated	11	5	3	1	20
Polypolish	-i 0.38 -v 0.61 -m 7 -d 3	random	13	3	3	3	22
Polypolish	-i 0.44 -v 0.8 -m 3 -d 3 --careful	mutated	10	5	4	1	20
Polypolish	-i 0.22 -v 0.27 -m 18 -d 15 --careful	random	18	17	12	9	56
Polypolish	-i 0.03 -v 0.56 -m 15 -d 13 --careful	random	18	17	12	9	56
Polypolish	-i 0.44 -v 0.8 -m 4 -d 2 --careful	mutated	16	5	3	4	28
Polypolish	-i 0.03 -v 0.95 -m 0 -d 6	random	18	18	18	18	72
Polypolish	-i 0.44 -v 0.8 -m 4 -d 3 --careful	mutated	10	5	3	4	22
Polypolish	-i 0.23 -v 0.28 -m 4 -d 13	random	18	17	11	9	55
Polypolish	-i 0.73 -v 0.94 -m 6 -d 16	random	18	17	14	13	62
Polypolish	-i 0.44 -v 0.78 -m 3 -d 3 --careful	mutated	10	5	4	1	20
Polypolish	-i 0.67 -v 0.96 -m 7 -d 14 --careful	random	18	17	11	9	55
Polypolish	-i 0.44 -v 0.84 -m 3 -d 3	mutated	11	5	3	1	20
Polypolish	-i 0.21 -v 0.78 -m 16 -d 11 --careful	random	17	13	9	7	46
Polypolish	-i 0.65 -v 0.83 -m 2 -d 12 --careful	random	18	17	12	9	56
Polypolish	-i 0.44 -v 0.84 -m 3 -d 4 --careful	mutated	13	8	4	4	29
Polypolish	-i 0.36 -v 0.53 -m 3 -d 18 --careful	random	18	18	15	12	63
Polypolish	-i 0.27 -v 0.57 -m 20 -d 14 --careful	random	18	17	11	9	55
Polypolish	-i 0.49 -v 0.62 -m 3 -d 5 --careful	random	14	8	4	4	30
Polypolish	-i 0.52 -v 0.78 -m 1 -d 14	random	18	17	16	14	65
Polypolish	-i 0.44 -v 0.79 -m 3 -d 3	mutated	11	5	3	1	20
Polypolish	-i 0.55 -v 0.62 -m 20 -d 5 --careful	random	14	8	4	1	27
Polypolish	-i 0.46 -v 0.79 -m 3 -d 3	mutated	11	5	3	1	20
Polypolish	-i 0.5 -v 0.71 -m 18 -d 13 --careful	random	17	16	10	9	52
Polypolish	-i 0.41 -v 0.79 -m 2 -d 2 --careful	mutated	14	4	4	4	26
Polypolish	-i 0.27 -v 0.48 -m 20 -d 9 --careful	random	17	10	7	6	40
Polypolish	-i 0.46 -v 0.77 -m 3 -d 2	mutated	16	5	3	1	25
Polypolish	-i 0.22 -v 0.43 -m 6 -d 1 --careful	random	10	5	4	4	23
Polypolish	-i 0.46 -v 0.79 -m 4 -d 4 --careful	mutated	13	8	4	4	29
Polypolish	-i 0.62 -v 0.95 -m 20 -d 18 --careful	random	18	18	12	10	58
Polypolish	-i 0.46 -v 0.79 -m 3 -d 3 --careful	mutated	10	5	4	1	20
Polypolish	-i 0.27 -v 0.39 -m 11 -d 16	random	18	17	12	9	56
Polypolish	-i 0.38 -v 0.69 -m 5 -d 11	random	17	13	9	7	46
Polypolish	-i 0.49 -v 0.79 -m 3 -d 3 --careful	mutated	10	5	4	1	20
Polypolish	-i 0.53 -v 0.71 -m 7 -d 8	random	20	10	9	4	43
Polypolish	-i 0.49 -v 0.84 -m 3 -d 3	mutated	11	5	3	1	20
Polypolish	-i 0.08 -v 0.99 -m 20 -d 18	random	18	18	12	10	58
Polypolish	-i 0.49 -v 0.92 -m 3 -d 3 --careful	mutated	10	5	4	1	20
Polypolish	-i 0.31 -v 0.62 -m 9 -d 18	random	18	18	13	10	59
Polypolish	-i 0.49 -v 0.92 -m 4 -d 3	mutated	11	5	4	4	24
Polypolish	-i 0.39 -v 0.49 -m 10 -d 18 --careful	random	18	18	12	10	58
Polypolish	-i 0.49 -v 0.92 -m 2 -d 3 --careful	mutated	10	6	4	4	24
Polypolish	-i 0.13 -v 0.47 -m 7 -d 8 --careful	random	17	10	6	4	37
Polypolish	-i 0.49 -v 0.88 -m 2 -d 3 --careful	mutated	10	6	4	4	24
Polypolish	-i 0.27 -v 0.41 -m 5 -d 15	random	18	17	12	9	56
Polypolish	-i 0.29 -v 0.32 -m 11 -d 1	random	20	4	0	3	27
Polypolish	-i 0.55 -v 0.92 -m 3 -d 3 --careful	mutated	10	5	4	1	20
Polypolish	-i 0.28 -v 0.72 -m 15 -d 4 --careful	random	13	8	4	4	29
Polypolish	-i 0.49 -v 0.92 -m 3 -d 4 --careful	mutated	13	8	4	4	29
Polypolish	-i 0.26 -v 0.43 -m 20 -d 12	random	17	15	10	8	50
Polypolish	-i 0.55 -v 0.92 -m 4 -d 3	mutated	11	5	4	4	24
Polypolish	-i 0.5 -v 0.77 -m 5 -d 10	random	17	13	8	6	44
Polypolish	-i 0.55 -v 0.94 -m 3 -d 4 --careful	mutated	13	8	5	4	30
Polypolish	-i 0.28 -v 0.78 -m 0 -d 7	random	18	18	18	18	72
Polypolish	-i 0.63 -v 0.92 -m 3 -d 3 --careful	mutated	10	5	4	1	20
Polypolish	-i 0.29 -v 0.7 -m 1 -d 6 --careful	random	17	12	8	6	43
Polypolish	-i 0.64 -v 0.92 -m 2 -d 4 --careful	mutated	13	8	4	4	29
Polypolish	-i 0.16 -v 0.36 -m 20 -d 4	random	13	8	5	4	30
Polypolish	-i 0.15 -v 0.34 -m 11 -d 7 --careful	random	17	10	5	4	36
Polypolish	-i 0.63 -v 0.86 -m 4 -d 3 --careful	mutated	10	5	3	4	22
Polypolish	-i 0.15 -v 0.6 -m 6 -d 12	random	17	15	10	8	50
Polypolish	-i 0.68 -v 0.92 -m 3 -d 3	mutated	12	6	6	3	27
Polypolish	-i 0.4 -v 0.48 -m 15 -d 11	random	17	13	9	7	46
Polypolish	-i 0.43 -v 0.67 -m 20 -d 1	random	25	4	3	4	36
Polypolish	-i 0.63 -v 0.92 -m 3 -d 4 --careful	mutated	13	8	4	4	29
Polypolish	-i 0.23 -v 0.64 -m 0 -d 10 --careful	random	18	18	18	18	72
Polypolish	-i 0.7 -v 0.92 -m 3 -d 3 --careful	mutated	10	5	4	1	20
Polypolish	-i 0.1 -v 0.97 -m 10 -d 12	random	17	15	11	8	51
Polypolish	-i 0.7 -v 0.92 -m 4 -d 3	mutated	14	7	5	7	33
Polypolish	-i 0.37 -v 0.88 -m 9 -d 17 --careful	random	18	17	12	10	57
Polypolish	-i 0.7 -v 0.84 -m 4 -d 3	mutated	18	7	4	7	36
Polypolish	-i 0.62 -v 0.62 -m 14 -d 2	random	inf	inf	inf	inf	inf
Polypolish	-i 0.57 -v 0.57 -m 14 -d 9 --careful	random	inf	inf	inf	inf	inf
Polypolish	-i 0.49 -v 0.69 -m 13 -d 16	random	18	17	12	9	56
Polypolish	-i 0.7 -v 0.98 -m 2 -d 2	mutated	17	6	6	7	36
Polypolish	-i 0.39 -v 0.75 -m 5 -d 8	random	17	10	6	4	37
Polypolish	-i 0.7 -v 0.94 -m 4 -d 3	mutated	14	7	6	7	34
Polypolish	-i 0.24 -v 0.45 -m 11 -d 3	random	12	5	1	3	21
Polypolish	-i 0.69 -v 0.92 -m 3 -d 2	mutated	18	6	7	3	34
Polypolish	-i 0.44 -v 0.74 -m 6 -d 16 --careful	random	18	17	12	10	57
Polypolish	-i 0.7 -v 0.92 -m 3 -d 3	mutated	13	7	7	4	31
Polypolish	-i 0.36 -v 0.49 -m 1 -d 9 --careful	random	18	15	12	10	55
Polypolish	-i 0.24 -v 0.62 -m 15 -d 6	random	17	9	4	4	34
Polypolish	-i 0.7 -v 1.0 -m 3 -d 3	mutated	inf	inf	inf	inf	inf
Polypolish	-i 0.69 -v 0.96 -m 7 -d 17 --careful	random	18	17	12	10	57
Polypolish	-i 0.06 -v 0.37 -m 9 -d 18	random	18	18	13	10	59
Polypolish	-i 0.61 -v 0.75 -m 14 -d 14	random	18	17	14	10	59
Polypolish	-i 0.7 -v 0.93 -m 3 -d 3	mutated	13	7	8	4	32
Polypolish	-i 0.57 -v 0.62 -m 15 -d 19	random	18	18	14	12	62
Polypolish	-i 0.7 -v 0.92 -m 2 -d 2	mutated	17	6	4	7	34
Polypolish	-i 0.46 -v 0.51 -m 1 -d 16 --careful	random	18	18	17	15	68
Polypolish	-i 0.68 -v 0.92 -m 4 -d 3 --careful	mutated	10	5	4	4	23
Polypolish	-i 0.2 -v 0.38 -m 14 -d 14	random	18	17	11	9	55
Polypolish	-i 0.65 -v 0.65 -m 4 -d 3	random	inf	inf	inf	inf	inf
Polypolish	-i 0.7 -v 0.92 -m 2 -d 3	mutated	13	8	4	7	32
Polypolish	-i 0.77 -v 0.78 -m 7 -d 6 --careful	random	17	9	4	4	34
Polypolish	-i 0.69 -v 0.92 -m 3 -d 3	mutated	13	6	7	3	29
Polypolish	-i 0.23 -v 0.56 -m 3 -d 5	random	14	8	4	4	30
Polypolish	-i 0.7 -v 0.86 -m 3 -d 3	mutated	14	7	6	4	31
Polypolish	-i 0.28 -v 0.39 -m 16 -d 5	random	14	8	1	4	27
Polypolish	-i 0.58 -v 0.83 -m 18 -d 17	random	18	17	12	10	57
Polypolish	-i 0.7 -v 1.0 -m 3 -d 4 --careful	mutated	inf	inf	inf	inf	inf
Polypolish	-i 0.34 -v 0.97 -m 12 -d 4 --careful	random	13	8	6	4	31
Polypolish	-i 0.72 -v 0.92 -m 3 -d 3 --careful	mutated	10	5	4	1	20
Polypolish	-i 0.08 -v 0.8 -m 2 -d 15	random	18	17	12	10	57
Polypolish	-i 0.76 -v 0.92 -m 3 -d 3	mutated	13	10	12	4	39
Polypolish	-i 0.6 -v 0.79 -m 3 -d 2	random	40	7	3	3	53
Polypolish	-i 0.66 -v 0.92 -m 3 -d 3	mutated	12	6	4	3	25
Polypolish	-i 0.58 -v 0.89 -m 14 -d 8	random	20	14	9	5	48
Polypolish	-i 0.78 -v 0.94 -m 3 -d 2	mutated	20	11	14	4	49
Polypolish	-i 0.31 -v 0.81 -m 18 -d 2	random	20	4	4	4	32
Polypolish	-i 0.72 -v 0.92 -m 2 -d 4	mutated	14	10	5	7	36
Polypolish	-i 0.04 -v 0.23 -m 8 -d 1 --careful	random	17	16	11	9	53
Polypolish	-i 0.72 -v 0.92 -m 3 -d 3	mutated	13	7	8	4	32
Polypolish	-i 0.36 -v 0.54 -m 19 -d 13 --careful	random	17	16	10	9	52
Polypolish	-i 0.72 -v 0.98 -m 3 -d 3 --careful	mutated	10	5	6	1	22
Polypolish	-i 0.17 -v 0.93 -m 2 -d 5	random	14	9	5	4	32
Polypolish	-i 0.12 -v 0.84 -m 16 -d 20 --careful	random	18	18	15	12	63
Polypolish	-i 0.08 -v 0.99 -m 12 -d 13 --careful	random	17	16	11	9	53
Polypolish	-i 0.72 -v 0.92 -m 2 -d 3	mutated	13	8	5	7	33
Polypolish	-i 0.15 -v 0.28 -m 13 -d 17 --careful	random	18	17	12	9	56
Polypolish	-i 0.72 -v 0.83 -m 3 -d 3	mutated	14	7	7	4	32
Polypolish	-i 0.3 -v 0.97 -m 17 -d 11	random	17	13	10	7	47
Polypolish	-i 0.72 -v 0.92 -m 4 -d 4 --careful	mutated	13	8	4	4	29
Polypolish	-i 0.41 -v 0.9 -m 7 -d 7 --careful	random	17	10	5	4	36
Polypolish	-i 0.8 -v 0.92 -m 3 -d 3 --careful	mutated	10	5	4	1	20
Polypolish	-i 0.24 -v 0.79 -m 10 -d 13 --careful	random	17	16	10	9	52
Polypolish	-i 0.06 -v 0.6 -m 2 -d 20	random	18	18	17	16	69
Polypolish	-i 0.8 -v 0.92 -m 3 -d 3	mutated	14	11	14	5	44
Polypolish	-i 0.7 -v 0.74 -m 19 -d 17 --careful	random	18	17	12	9	56
Polypolish	-i 0.14 -v 0.55 -m 0 -d 2	random	18	18	18	18	72
Polypolish	-i 0.8 -v 0.85 -m 2 -d 3 --careful	mutated	10	6	4	4	24
Polypolish	-i 0.45 -v 0.87 -m 19 -d 11 --careful	random	17	13	9	7	46
Polypolish	-i 0.8 -v 0.82 -m 2 -d 3 --careful	mutated	10	6	4	4	24
Polypolish	-i 0.04 -v 0.92 -m 8 -d 13 --careful	random	17	16	11	9	53
Polypolish	-i 0.8 -v 0.98 -m 3 -d 3	mutated	14	11	15	5	45
Polypolish	-i 0.08 -v 0.58 -m 4 -d 1 --careful	random	17	10	6	4	37
Polypolish	-i 0.8 -v 0.94 -m 3 -d 2	mutated	20	11	15	5	51
Polypolish	-i 0.29 -v 0.58 -m 17 -d 3 --careful	random	12	5	4	4	25
Polypolish	-i 0.25 -v 0.99 -m 3 -d 6 --careful	random	17	9	6	4	36
Polypolish	-i 0.67 -v 0.9 -m 11 -d 13	random	17	16	13	14	60
Polypolish	-i 0.8 -v 0.92 -m 3 -d 2	mutated	20	11	14	5	50
Polypolish	-i 0.31 -v 0.47 -m 9 -d 8	random	17	10	6	4	37
Polypolish	-i 0.25 -v 0.76 -m 7 -d 20 --careful	random	18	18	15	12	63
Polypolish	-i 0.12 -v 0.92 -m 8 -d 9 --careful	random	17	10	7	6	40
Polypolish	-i 0.74 -v 0.98 -m 1 -d 19	random	18	18	17	17	70
Polypolish	-i 0.8 -v 0.92 -m 3 -d 4 --careful	mutated	13	8	4	4	29
Polypolish	-i 0.29 -v 0.6 -m 12 -d 17 --careful	random	18	17	12	9	56
Polypolish	-i 0.12 -v 0.91 -m 15 -d 11	random	17	13	9	7	46
Polypolish	-i 0.79 -v 0.89 -m 1 -d 9	random	18	15	14	13	60
Polypolish	-i 0.8 -v 0.92 -m 3 -d 4	mutated	16	14	14	8	52
Polypolish	-i 0.4 -v 0.49 -m 16 -d 6 --careful	random	17	9	4	1	31
Polypolish	-i 0.06 -v 0.75 -m 9 -d 14	random	18	17	11	9	55
Polypolish	-i 0.8 -v 0.92 -m 4 -d 3 --careful	mutated	10	5	4	4	23
Polypolish	-i 0.78 -v 0.82 -m 1 -d 4 --careful	random	13	11	6	6	36
Polypolish	-i 0.8 -v 0.92 -m 4 -d 3	mutated	15	11	14	8	48
Polypolish	-i 0.12 -v 0.94 -m 1 -d 17	random	18	18	17	16	69
Polypolish	-i 0.51 -v 0.7 -m 14 -d 12 --careful	random	17	15	10	8	50
Polypolish	-i 0.43 -v 0.51 -m 14 -d 18 --careful	random	18	18	12	10	58
Polypolish	-i 0.8 -v 0.92 -m 2 -d 3	mutated	13	12	8	8	41
Polypolish	-i 0.12 -v 0.57 -m 1 -d 16 --careful	random	18	18	17	15	68
Polypolish	-i 0.8 -v 0.96 -m 3 -d 3 --careful	mutated	10	5	6	1	22
Polypolish	-i 0.27 -v 0.34 -m 9 -d 1	random	19	4	0	3	26
Polypolish	-i 0.8 -v 0.88 -m 3 -d 3 --careful	mutated	10	5	4	1	20
Polypolish	-i 0.4 -v 0.61 -m 12 -d 8 --careful	random	17	10	6	4	37
Polypolish	-i 0.8 -v 0.88 -m 3 -d 2 --careful	mutated	15	5	4	1	25
Polypolish	-i 0.33 -v 0.64 -m 2 -d 14	random	18	17	12	9	56
Polypolish	-i 0.8 -v 0.88 -m 3 -d 3	mutated	15	11	14	5	45
Polypolish	-i 0.27 -v 0.42 -m 7 -d 7 --careful	random	17	10	5	4	36
Polypolish	-i 0.8 -v 0.88 -m 4 -d 3 --careful	mutated	10	5	4	4	23
Polypolish	-i 0.32 -v 0.82 -m 13 -d 15 --careful	random	18	17	12	9	56
Polypolish	-i 0.61 -v 0.68 -m 13 -d 9 --careful	random	17	10	7	6	40
Polypolish	-i 0.18 -v 0.31 -m 6 -d 4	random	13	8	5	4	30
Polypolish	-i 0.31 -v 0.56 -m 0 -d 15 --careful	random	18	18	18	18	72
Polypolish	-i 0.8 -v 0.88 -m 3 -d 4	mutated	17	14	14	8	53
Polypolish	-i 0.22 -v 0.59 -m 17 -d 13	random	17	16	10	9	52
Polypolish	-i 0.75 -v 0.82 -m 3 -d 3	mutated	14	10	11	4	39
Polypolish	-i 0.04 -v 0.72 -m 6 -d 4	random	18	16	11	9	54
Polypolish	-i 0.13 -v 0.93 -m 1 -d 7	random	17	14	11	7	49
Polypolish	-i 0.8 -v 0.88 -m 4 -d 3	mutated	19	11	13	9	52
Polypolish	-i 0.65 -v 0.98 -m 15 -d 8	random	20	17	10	7	54
Polypolish	-i 0.76 -v 0.79 -m 3 -d 3 --careful	mutated	10	5	4	1	20
Polypolish	-i 0.61 -v 0.68 -m 2 -d 5 --careful	random	14	9	4	4	31
Polypolish	-i 0.7 -v 0.78 -m 3 -d 3	mutated	14	7	6	4	31
Polypolish	-i 0.61 -v 0.81 -m 0 -d 10 --careful	random	18	18	18	18	72
Polypolish	-i 0.71 -v 0.8 -m 3 -d 4	mutated	16	10	7	7	40
Polypolish	-i 0.21 -v 0.43 -m 3 -d 18 --careful	random	18	18	15	12	63
Polypolish	-i 0.76 -v 0.76 -m 2 -d 3 --careful	mutated	inf	inf	inf	inf	inf
Polypolish	-i 0.5 -v 0.81 -m 6 -d 1	random	46	9	4	4	63
Polypolish	-i 0.79 -v 0.79 -m 4 -d 3	mutated	inf	inf	inf	inf	inf
Polypolish	-i 0.58 -v 0.67 -m 18 -d 20	random	18	18	15	12	63
Polypolish	-i 0.79 -v 0.8 -m 4 -d 3 --careful	mutated	10	5	3	4	22
Polypolish	-i 0.27 -v 0.48 -m 1 -d 19 --careful	random	18	18	17	17	70
Polypolish	-i 0.76 -v 0.79 -m 4 -d 3 --careful	mutated	10	5	3	4	22
Polypolish	-i 0.22 -v 0.41 -m 11 -d 18 --careful	random	18	18	12	10	58
Polypolish	-i 0.71 -v 0.76 -m 2 -d 3	mutated	14	8	5	7	34
Polypolish	-i 0.29 -v 0.34 -m 18 -d 18	random	18	18	12	10	58
Polypolish	-i 0.73 -v 0.76 -m 2 -d 2 --careful	mutated	33	5	4	3	45
Polypolish	-i 0.16 -v 0.21 -m 13 -d 18 --careful	random	18	18	12	10	58
Polypolish	-i 0.71 -v 0.79 -m 4 -d 3 --careful	mutated	10	5	3	4	22
Polypolish	-i 0.73 -v 0.86 -m 2 -d 15	random	18	17	12	13	60
Polypolish	-i 0.8 -v 0.87 -m 3 -d 3 --careful	mutated	10	5	4	1	20
Polypolish	-i 0.53 -v 0.79 -m 17 -d 9 --careful	random	17	10	7	6	40
Polypolish	-i 0.8 -v 0.93 -m 3 -d 2	mutated	20	11	15	5	51
Polypolish	-i 0.17 -v 0.28 -m 2 -d 20 --careful	random	18	18	17	16	69
Polypolish	-i 0.14 -v 0.82 -m 16 -d 14	random	18	17	11	9	55
Polypolish	-i 0.8 -v 0.95 -m 3 -d 3 --careful	mutated	10	5	5	1	21
Polypolish	-i 0.45 -v 0.9 -m 15 -d 17	random	18	17	12	9	56
Polypolish	-i 0.8 -v 0.87 -m 2 -d 3 --careful	mutated	10	6	4	4	24
Polypolish	-i 0.46 -v 0.75 -m 10 -d 13 --careful	random	17	16	10	9	52
Polypolish	-i 0.8 -v 0.87 -m 3 -d 3	mutated	15	11	13	5	44
Polypolish	-i 0.38 -v 0.53 -m 17 -d 3	random	14	3	3	3	23
Polypolish	-i 0.8 -v 0.87 -m 2 -d 3	mutated	14	12	8	8	42
Polypolish	-i 0.5 -v 0.72 -m 13 -d 9	random	17	12	10	6	45
Polypolish	-i 0.43 -v 0.44 -m 1 -d 1	random	16	5	5	6	32
Polypolish	-i 0.8 -v 0.87 -m 2 -d 2	mutated	18	10	8	8	44
Polypolish	-i 0.48 -v 0.84 -m 10 -d 15	random	18	17	12	9	56
Polypolish	-i 0.64 -v 0.7 -m 8 -d 10	random	17	13	10	8	48
Polypolish	-i 0.22 -v 0.58 -m 11 -d 5 --careful	random	14	8	4	4	30
Polypolish	-i 0.57 -v 0.78 -m 17 -d 9	random	17	14	10	6	47
Polypolish	-i 0.22 -v 0.23 -m 3 -d 17 --careful	random	18	18	12	11	59
Polypolish	-i 0.8 -v 0.87 -m 3 -d 4 --careful	mutated	13	8	4	4	29
Polypolish	-i 0.31 -v 0.32 -m 12 -d 19 --careful	random	18	18	14	12	62
Polypolish	-i 0.62 -v 0.64 -m 17 -d 19	random	18	18	14	13	63
Polypolish	-i 0.62 -v 0.96 -m 9 -d 8 --careful	random	17	10	6	4	37
Polypolish	-i 0.8 -v 0.87 -m 3 -d 4	mutated	17	14	14	8	53
Polypolish	-i 0.32 -v 0.84 -m 12 -d 9	random	17	10	7	6	40
Polypolish	-i 0.22 -v 0.71 -m 6 -d 16 --careful	random	18	17	12	10	57
Polypolish	-i 0.75 -v 0.88 -m 3 -d 3 --careful	mutated	10	5	4	1	20
Polypolish	-i 0.26 -v 0.78 -m 20 -d 20	random	18	18	15	12	63
Polypolish	-i 0.67 -v 0.88 -m 2 -d 3	mutated	12	8	4	7	31
Polypolish	-i 0.37 -v 0.58 -m 16 -d 4	random	14	8	3	3	28
Polypolish	-i 0.49 -v 0.5 -m 1 -d 12 --careful	random	18	17	16	13	64
Polypolish	-i 0.75 -v 0.88 -m 4 -d 3	mutated	18	9	8	8	43
Polypolish	-i 0.33 -v 0.74 -m 14 -d 1 --careful	random	21	5	4	4	34
Polypolish	-i 0.75 -v 0.88 -m 2 -d 3	mutated	14	8	5	7	34
Polypolish	-i 0.59 -v 0.64 -m 17 -d 15 --careful	random	18	17	12	9	56
Polypolish	-i 0.75 -v 0.88 -m 3 -d 3	mutated	14	10	12	4	40
Polypolish	-i 0.7 -v 0.87 -m 2 -d 11 --careful	random	18	16	11	9	54
Polypolish	-i 0.75 -v 0.8 -m 4 -d 3 --careful	mutated	10	5	3	4	22
Polypolish	-i 0.04 -v 0.34 -m 2 -d 5 --careful	random	18	17	12	9	56
Polypolish	-i 0.29 -v 0.67 -m 2 -d 17	random	18	18	14	14	64
Polypolish	-i 0.66 -v 0.71 -m 1 -d 4 --careful	random	13	11	6	6	36
Polypolish	-i 0.18 -v 0.63 -m 8 -d 12	random	17	15	10	8	50
Polypolish	-i 0.77 -v 0.88 -m 3 -d 2 --careful	mutated	15	5	4	1	25
Polypolish	-i 0.45 -v 0.91 -m 16 -d 4 --careful	random	13	8	4	4	29
Polypolish	-i 0.43 -v 0.7 -m 17 -d 2 --careful	random	22	5	3	4	34
Polypolish	-i 0.38 -v 0.43 -m 7 -d 15	random	18	17	12	9	56
Polypolish	-i 0.75 -v 0.91 -m 11 -d 15 --careful	random	18	17	12	9	56
Polypolish	-i 0.78 -v 0.88 -m 2 -d 3	mutated	14	11	6	7	38
Polypolish	-i 0.42 -v 0.76 -m 17 -d 10	random	17	13	7	6	43
Polypolish	-i 0.64 -v 0.8 -m 2 -d 14 --careful	random	18	17	12	9	56
Polypolish	-i 0.66 -v 0.88 -m 3 -d 3 --careful	mutated	10	5	4	1	20
Polypolish	-i 0.01 -v 0.55 -m 1 -d 20	random	18	18	18	18	72
Polypolish	-i 0.66 -v 0.88 -m 3 -d 4 --careful	mutated	13	8	4	4	29
Polypolish	-i 0.42 -v 0.74 -m 11 -d 13 --careful	random	17	16	10	9	52
Polypolish	-i 0.66 -v 0.81 -m 3 -d 2	mutated	41	8	3	3	55
Polypolish	-i 0.25 -v 0.78 -m 10 -d 4	random	13	8	4	4	29
Polypolish	-i 0.66 -v 0.88 -m 3 -d 2	mutated	17	6	4	3	30
Polypolish	-i 0.43 -v 0.73 -m 8 -d 19	random	18	18	14	12	62
Polypolish	-i 0.66 -v 0.88 -m 4 -d 3 --careful	mutated	10	5	4	4	23
Polypolish	-i 0.04 -v 0.43 -m 13 -d 16	random	18	17	12	9	56
Polypolish	-i 0.39 -v 0.84 -m 16 -d 14	random	18	17	11	9	55
Polypolish	-i 0.66 -v 0.88 -m 4 -d 3	mutated	13	7	3	7	30
Polypolish	-i 0.65 -v 0.75 -m 13 -d 2 --careful	random	57	10	5	4	76
Polypolish	-i 0.66 -v 0.88 -m 3 -d 3	mutated	12	6	4	3	25
Polypolish	-i 0.16 -v 0.5 -m 10 -d 11	random	17	13	9	7	46
Polypolish	-i 0.12 -v 1.0 -m 3 -d 17	random	inf	inf	inf	inf	inf
Polypolish	-i 0.58 -v 0.88 -m 4 -d 3	mutated	12	5	3	5	25
Polypolish	-i 0.47 -v 0.53 -m 16 -d 4	random	18	8	6	0	32
Polypolish	-i 0.14 -v 0.3 -m 12 -d 8	random	17	10	6	4	37
Polypolish	-i 0.48 -v 0.74 -m 20 -d 6	random	20	11	7	4	42
Polypolish	-i 0.68 -v 0.85 -m 3 -d 3	mutated	12	6	5	3	26
Polypolish	-i 0.19 -v 0.84 -m 8 -d 4	random	13	8	5	4	30
Polypolish	-i 0.39 -v 0.48 -m 15 -d 17 --careful	random	18	17	12	9	56
Polypolish	-i 0.68 -v 0.88 -m 3 -d 3 --careful	mutated	10	5	4	1	20
Polypolish	-i 0.22 -v 0.43 -m 3 -d 19 --careful	random	18	18	15	12	63
Polypolish	-i 0.3 -v 0.45 -m 12 -d 19	random	18	18	14	12	62
Polypolish	-i 0.68 -v 0.86 -m 2 -d 2	mutated	16	6	4	7	33
Polypolish	-i 0.16 -v 0.77 -m 7 -d 2 --careful	random	13	8	5	4	30
Polypolish	-i 0.68 -v 0.84 -m 3 -d 3	mutated	12	6	5	3	26
Polypolish	-i 0.6 -v 0.92 -m 19 -d 4 --careful	random	13	8	4	4	29
Polypolish	-i 0.32 -v 0.59 -m 16 -d 15 --careful	random	18	17	12	9	56
Polypolish	-i 0.58 -v 0.88 -m 3 -d 3 --careful	mutated	10	5	4	1	20
Polypolish	-i 0.11 -v 0.53 -m 12 -d 15 --careful	random	18	17	12	9	56
Polypolish	-i 0.62 -v 0.88 -m 2 -d 2	mutated	15	4	4	6	29
Polypolish	-i 0.54 -v 0.6 -m 16 -d 13	random	17	16	13	9	55
Polypolish	-i 0.49 -v 0.54 -m 6 -d 4 --careful	random	13	6	4	1	24
Polypolish	-i 0.58 -v 0.93 -m 2 -d 3	mutated	11	6	5	4	26
Polypolish	-i 0.72 -v 0.81 -m 18 -d 12 --careful	random	17	15	10	8	50
Polypolish	-i 0.58 -v 0.88 -m 3 -d 4 --careful	mutated	13	8	4	4	29
Polypolish	-i 0.28 -v 0.34 -m 10 -d 5 --careful	random	14	8	1	4	27
Polypolish	-i 0.64 -v 0.88 -m 3 -d 3	mutated	12	6	4	3	25
Polypolish	-i 0.59 -v 0.6 -m 1 -d 18	random	18	18	17	16	69
Polypolish	-i 0.59 -v 0.6 -m 2 -d 6 --careful	random	17	10	4	4	35
Polypolish	-i 0.51 -v 0.97 -m 3 -d 3	mutated	11	5	6	1	23
Polypolish	-i 0.26 -v 0.81 -m 10 -d 14 --careful	random	18	17	11	9	55
Polypolish	-i 0.58 -v 0.78 -m 4 -d 3	mutated	12	5	3	5	25
Polypolish	-i 0.33 -v 0.58 -m 5 -d 16 --careful	random	18	17	12	10	57
Polypolish	-i 0.13 -v 0.47 -m 15 -d 10 --careful	random	17	13	7	6	43
Polypolish	-i 0.36 -v 0.73 -m 16 -d 1 --careful	random	21	5	4	4	34
Polypolish	-i 0.58 -v 0.9 -m 3 -d 3 --careful	mutated	10	5	4	1	20
Polypolish	-i 0.58 -v 0.87 -m 5 -d 16	random	18	17	12	11	58
Polypolish	-i 0.58 -v 0.98 -m 3 -d 3 --careful	mutated	10	5	6	1	22
Polypolish	-i 0.51 -v 0.81 -m 7 -d 10 --careful	random	17	13	7	6	43
Polypolish	-i 0.58 -v 0.9 -m 3 -d 2 --careful	mutated	15	5	4	1	25
Polypolish	-i 0.36 -v 0.98 -m 14 -d 17 --careful	random	18	17	12	9	56
Polypolish	-i 0.58 -v 0.9 -m 3 -d 3	mutated	11	5	4	2	22
Polypolish	-i 0.61 -v 0.63 -m 9 -d 12 --careful	random	17	15	10	8	50
Polypolish	-i 0.25 -v 0.32 -m 11 -d 19	random	18	18	14	12	62
Polypolish	-i 0.58 -v 0.9 -m 2 -d 3 --careful	mutated	10	6	4	4	24
Polypolish	-i 0.44 -v 0.74 -m 15 -d 18 --careful	random	18	18	12	10	58
Polypolish	-i 0.1 -v 0.41 -m 7 -d 3 --careful	random	17	9	6	4	36
Polypolish	-i 0.37 -v 0.6 -m 1 -d 9 --careful	random	18	15	12	10	55
Polypolish	-i 0.58 -v 0.9 -m 4 -d 3 --careful	mutated	10	5	4	4	23
Polypolish	-i 0.46 -v 0.68 -m 13 -d 1 --careful	random	22	5	3	1	31
Polypolish	-i 0.58 -v 0.82 -m 3 -d 3	mutated	11	5	3	2	21
Polypolish	-i 0.1 -v 0.91 -m 9 -d 10 --careful	random	17	13	8	6	44
Polypolish	-i 0.58 -v 0.9 -m 4 -d 3	mutated	12	5	3	5	25
Polypolish	-i 0.37 -v 0.91 -m 18 -d 17	random	18	17	12	9	56
Polypolish	-i 0.58 -v 0.9 -m 3 -d 4	mutated	14	8	4	5	31
Polypolish	-i 0.39 -v 0.61 -m 18 -d 17	random	18	17	12	9	56
Polypolish	-i 0.55 -v 0.8 -m 17 -d 14	random	18	17	14	9	58
Polypolish	-i 0.29 -v 0.91 -m 5 -d 13 --careful	random	18	16	11	9	54
Polypolish	-i 0.55 -v 0.94 -m 3 -d 10	random	17	14	9	7	47
Polypolish	-i 0.51 -v 0.9 -m 2 -d 3	mutated	11	6	4	4	25
Polypolish	-i 0.55 -v 0.57 -m 1 -d 5 --careful	random	15	12	8	6	41
Polypolish	-i 0.27 -v 0.42 -m 7 -d 20 --careful	random	18	18	15	12	63
Polypolish	-i 0.51 -v 0.9 -m 3 -d 3	mutated	11	5	4	1	21
Polypolish	-i 0.52 -v 0.92 -m 15 -d 19	random	18	18	14	12	62
Polypolish	-i 0.55 -v 0.9 -m 3 -d 3 --careful	mutated	10	5	4	1	20
Polypolish	-i 0.01 -v 0.4 -m 16 -d 13	random	18	18	18	18	72
Polypolish	-i 0.55 -v 0.9 -m 3 -d 4	mutated	14	8	4	5	31
Polypolish	-i 0.08 -v 0.37 -m 15 -d 12 --careful	random	17	15	11	8	51
Polypolish	-i 0.55 -v 0.96 -m 3 -d 4	mutated	14	8	6	5	33
Polypolish	-i 0.32 -v 0.74 -m 9 -d 11 --careful	random	17	13	9	7	46
Polypolish	-i 0.55 -v 0.9 -m 3 -d 2	mutated	16	5	4	2	27
Polypolish	-i 0.08 -v 0.62 -m 7 -d 11 --careful	random	17	13	10	7	47
Polypolish	-i 0.63 -v 0.9 -m 3 -d 3	mutated	12	6	4	3	25
Polypolish	-i 0.14 -v 0.32 -m 18 -d 14	random	18	17	11	9	55
Polypolish	-i 0.55 -v 0.9 -m 3 -d 3	mutated	11	5	4	2	22
Polypolish	-i 0.27 -v 0.35 -m 11 -d 6	random	17	9	1	4	31
Polypolish	-i 0.53 -v 0.84 -m 3 -d 3 --careful	mutated	10	5	4	1	20
Polypolish	-i 0.3 -v 0.34 -m 15 -d 17	random	18	17	12	9	56
Polypolish	-i 0.43 -v 0.99 -m 8 -d 7 --careful	random	17	10	6	4	37
Polypolish	-i 0.53 -v 0.84 -m 3 -d 2 --careful	mutated	15	5	4	1	25
Polypolish	-i 0.37 -v 0.71 -m 13 -d 11	random	17	13	9	7	46
Polypolish	-i 0.53 -v 0.84 -m 3 -d 4 --careful	mutated	13	8	4	4	29
Polypolish	-i 0.22 -v 0.83 -m 4 -d 10 --careful	random	17	13	9	6	45
Polypolish	-i 0.46 -v 0.84 -m 3 -d 4	mutated	14	8	4	4	30
Polypolish	-i 0.45 -v 0.49 -m 3 -d 2 --careful	random	15	3	2	1	21
Polypolish	-i 0.58 -v 0.84 -m 4 -d 2 --careful	mutated	16	5	3	4	28
Polypolish	-i 0.77 -v 0.82 -m 10 -d 10	random	17	23	16	16	72
Polypolish	-i 0.53 -v 0.84 -m 2 -d 3	mutated	11	6	4	4	25
Polypolish	-i 0.57 -v 0.89 -m 6 -d 6 --careful	random	17	9	4	4	34
Polypolish	-i 0.53 -v 0.84 -m 3 -d 2	mutated	16	5	3	2	26
Polypolish	-i 0.66 -v 0.72 -m 1 -d 9	random	18	15	13	10	56
Polypolish	-i 0.54 -v 0.84 -m 3 -d 3	mutated	11	5	3	2	21
Polypolish	-i 0.05 -v 0.39 -m 8 -d 18	random	18	18	13	10	59
Polypolish	-i 0.53 -v 0.84 -m 4 -d 3 --careful	mutated	10	5	3	4	22
Polypolish	-i 0.5 -v 0.8 -m 12 -d 1 --careful	random	56	10	5	4	75
Polypolish	-i 0.56 -v 0.86 -m 2 -d 1	random	273	17	6	4	300
Polypolish	-i 0.53 -v 0.91 -m 3 -d 3	mutated	11	5	4	2	22
Polypolish	-i 0.06 -v 0.83 -m 12 -d 14	random	18	17	11	9	55
Polypolish	-i 0.41 -v 0.53 -m 17 -d 18	random	18	18	12	10	58
Polypolish	-i 0.24 -v 0.69 -m 6 -d 7	random	17	10	5	4	36
Polypolish	-i 0.53 -v 0.84 -m 3 -d 3	mutated	11	5	3	2	21
Polypolish	-i 0.23 -v 0.52 -m 8 -d 11	random	17	13	9	7	46
Polypolish	-i 0.53 -v 0.82 -m 3 -d 3	mutated	11	5	3	2	21
Polypolish	-i 0.44 -v 0.9 -m 6 -d 17	random	18	17	12	10	57
Polypolish	-i 0.53 -v 0.94 -m 3 -d 2 --careful	mutated	15	5	5	1	26
Polypolish	-i 0.12 -v 0.27 -m 9 -d 8 --careful	random	17	10	6	4	37
Polypolish	-i 0.3 -v 0.82 -m 18 -d 2	random	20	4	4	4	32
Polypolish	-i 0.49 -v 0.7 -m 8 -d 4 --careful	random	13	8	4	4	29
Polypolish	-i 0.71 -v 0.76 -m 2 -d 2	random	37	7	4	7	55
Polypolish	-i 0.03 -v 0.43 -m 6 -d 17	random	18	17	12	10	57
Polypolish	-i 0.53 -v 0.84 -m 3 -d 4	mutated	14	8	4	5	31
Polypolish	-i 0.03 -v 0.48 -m 20 -d 12 --careful	random	18	17	12	9	56
Polypolish	-i 0.58 -v 0.84 -m 3 -d 3	mutated	11	5	3	2	21
Polypolish	-i 0.33 -v 0.79 -m 2 -d 11	random	18	16	11	9	54
Polypolish	-i 0.19 -v 0.98 -m 12 -d 9 --careful	random	17	10	8	6	41
Polypolish	-i 0.53 -v 0.93 -m 3 -d 3 --careful	mutated	10	5	5	1	21
Polypolish	-i 0.64 -v 0.69 -m 14 -d 14	random	18	17	14	10	59
Polypolish	-i 0.25 -v 0.56 -m 17 -d 19	random	18	18	14	12	62
Polypolish	-i 0.53 -v 0.78 -m 4 -d 3 --careful	mutated	10	5	3	4	22
Polypolish	-i 0.76 -v 0.95 -m 17 -d 9	random	17	21	16	16	70
Polypolish	-i 0.53 -v 0.84 -m 2 -d 3 --careful	mutated	10	6	4	4	24
Polypolish	-i 0.33 -v 0.43 -m 20 -d 10 --careful	random	17	13	7	6	43
Polypolish	-i 0.61 -v 0.84 -m 3 -d 3 --careful	mutated	10	5	4	1	20
Polypolish	-i 0.1 -v 0.39 -m 15 -d 9 --careful	random	17	10	8	6	41
Polypolish	-i 0.61 -v 0.92 -m 3 -d 4	mutated	14	8	4	6	32
Polypolish	-i 0.25 -v 0.76 -m 0 -d 9 --careful	random	18	18	18	18	72
Polypolish	-i 0.21 -v 0.42 -m 2 -d 6 --careful	random	17	10	5	4	36
Polypolish	-i 0.61 -v 0.84 -m 3 -d 4 --careful	mutated	13	8	4	4	29
Polypolish	-i 0.29 -v 0.8 -m 20 -d 11	random	17	13	9	7	46
Polypolish	-i 0.62 -v 0.84 -m 3 -d 4	mutated	14	9	4	6	33
Polypolish	-i 0.44 -v 0.58 -m 9 -d 18 --careful	random	18	18	13	10	59
Polypolish	-i 0.64 -v 0.84 -m 2 -d 3 --careful	mutated	10	6	4	4	24
Polypolish	-i 0.27 -v 0.92 -m 8 -d 12	random	17	15	10	8	50
Polypolish	-i 0.61 -v 0.84 -m 3 -d 4	mutated	14	8	4	6	32
Polypolish	-i 0.35 -v 0.95 -m 2 -d 12	random	18	17	12	9	56
Polypolish	-i 0.61 -v 0.84 -m 3 -d 3	mutated	11	5	3	3	22
Polypolish	-i 0.51 -v 0.62 -m 10 -d 16	random	18	17	12	9	56
Polypolish	-i 0.61 -v 0.84 -m 2 -d 4	mutated	13	8	4	6	31
Polypolish	-i 0.35 -v 0.36 -m 9 -d 17 --careful	random	18	17	12	10	57
Polypolish	-i 0.19 -v 0.79 -m 9 -d 9	random	17	10	7	6	40
Polypolish	-i 0.61 -v 0.84 -m 2 -d 4 --careful	mutated	13	8	4	4	29
Polypolish	-i 0.49 -v 0.8 -m 16 -d 15	random	18	17	12	9	56
Polypolish	-i 0.61 -v 0.84 -m 2 -d 3 --careful	mutated	10	6	4	4	24
Polypolish	-i 0.22 -v 0.41 -m 8 -d 16 --careful	random	18	17	12	10	57
Polypolish	-i 0.57 -v 0.84 -m 4 -d 4	mutated	15	8	3	5	31
Polypolish	-i 0.35 -v 0.48 -m 5 -d 10	random	17	13	8	6	44
Polypolish	-i 0.64 -v 0.84 -m 2 -d 3	mutated	12	7	4	6	29
Polypolish	-i 0.73 -v 0.79 -m 10 -d 19 --careful	random	18	18	14	12	62
Polypolish	-i 0.68 -v 0.84 -m 3 -d 3 --careful	mutated	10	5	4	1	20
Polypolish	-i 0.29 -v 0.62 -m 5 -d 8	random	17	10	6	4	37
Polypolish	-i 0.26 -v 0.71 -m 8 -d 8 --careful	random	17	10	6	4	37
Polypolish	-i 0.68 -v 0.9 -m 3 -d 4	mutated	15	9	6	6	36
Polypolish	-i 0.53 -v 0.82 -m 0 -d 2 --careful	random	18	18	18	18	72
Polypolish	-i 0.45 -v 0.53 -m 15 -d 4 --careful	random	13	6	4	1	24
Polypolish	-i 0.71 -v 0.87 -m 3 -d 4 --careful	mutated	13	8	4	4	29
Polypolish	-i 0.52 -v 0.61 -m 19 -d 13 --careful	random	17	16	10	9	52
Polypolish	-i 0.52 -v 0.56 -m 1 -d 10 --careful	random	18	16	13	10	57
Polypolish	-i 0.77 -v 0.84 -m 4 -d 3 --careful	mutated	10	5	3	4	22
Polypolish	-i 0.23 -v 0.33 -m 6 -d 7 --careful	random	17	10	5	4	36
Polypolish	-i 0.62 -v 0.85 -m 4 -d 3	mutated	12	6	3	6	27
Polypolish	-i 0.56 -v 0.79 -m 6 -d 14	random	18	17	12	9	56
Polypolish	-i 0.7 -v 0.97 -m 8 -d 4 --careful	random	13	8	6	4	31
Polypolish	-i 0.25 -v 0.51 -m 5 -d 11 --careful	random	17	13	9	7	46
Polypolish	-i 0.68 -v 0.94 -m 3 -d 4 --careful	mutated	13	8	5	4	30
Polypolish	-i 0.47 -v 0.49 -m 15 -d 7 --careful	random	17	10	5	4	36
Polypolish	-i 0.63 -v 0.84 -m 3 -d 4	mutated	15	9	4	6	34
Polypolish	-i 0.45 -v 1.0 -m 7 -d 11 --careful	random	inf	inf	inf	inf	inf
Polypolish	-i 0.68 -v 0.84 -m 2 -d 3	mutated	12	8	4	7	31
Polypolish	-i 0.14 -v 0.22 -m 3 -d 14	random	18	17	12	9	56
Polypolish	-i 0.5 -v 0.73 -m 17 -d 4 --careful	random	13	8	4	4	29
Polypolish	-i 0.22 -v 0.37 -m 4 -d 7 --careful	random	17	10	5	4	36
Polypolish	-i 0.27 -v 0.48 -m 9 -d 16	random	18	17	12	9	56
Polypolish	-i 0.68 -v 0.92 -m 3 -d 2 --careful	mutated	15	5	4	1	25
Polypolish	-i 0.24 -v 0.69 -m 4 -d 19	random	18	18	15	12	63
Polypolish	-i 0.68 -v 0.88 -m 2 -d 2 --careful	mutated	14	4	4	4	26
Polypolish	-i 0.17 -v 0.31 -m 19 -d 15 --careful	random	18	17	12	9	56
Polypolish	-i 0.68 -v 0.84 -m 2 -d 3 --careful	mutated	10	6	4	4	24
Polypolish	-i 0.66 -v 0.71 -m 8 -d 8	random	20	12	9	7	48
Polypolish	-i 0.68 -v 0.82 -m 3 -d 3	mutated	12	6	5	3	26
Polypolish	-i 0.03 -v 0.61 -m 0 -d 9 --careful	random	18	18	18	18	72
Polypolish	-i 0.68 -v 0.84 -m 3 -d 2	mutated	17	6	5	3	31
Polypolish	-i 0.55 -v 0.87 -m 12 -d 16	random	18	17	12	9	56
Polypolish	-i 0.73 -v 0.84 -m 3 -d 4	mutated	16	10	10	7	43
Polypolish	-i 0.19 -v 0.95 -m 19 -d 4 --careful	random	13	8	5	4	30
Polypolish	-i 0.73 -v 0.74 -m 2 -d 3 --careful	mutated	10	6	4	4	24
Polypolish	-i 0.63 -v 0.75 -m 7 -d 1 --careful	random	451	37	17	9	514
Polypolish	-i 0.68 -v 0.84 -m 4 -d 3 --careful	mutated	10	5	3	4	22
Polypolish	-i 0.05 -v 0.62 -m 12 -d 4 --careful	random	17	13	10	7	47
Polypolish	-i 0.68 -v 0.84 -m 3 -d 4 --careful	mutated	13	8	4	4	29
Polypolish	-i 0.24 -v 0.49 -m 17 -d 15 --careful	random	18	17	12	9	56
Polypolish	-i 0.68 -v 0.84 -m 3 -d 2 --careful	mutated	15	5	4	1	25
Polypolish	-i 0.24 -v 0.29 -m 17 -d 10 --careful	random	17	13	7	6	43
Polypolish	-i 0.12 -v 0.45 -m 5 -d 10 --careful	random	17	13	8	6	44
Polypolish	-i 0.68 -v 0.83 -m 3 -d 3 --careful	mutated	10	5	4	1	20
Polypolish	-i 0.25 -v 0.99 -m 19 -d 1	random	12	5	6	4	27
Polypolish	-i 0.21 -v 0.68 -m 2 -d 2	random	11	6	5	4	26
Polypolish	-i 0.68 -v 0.83 -m 3 -d 4 --careful	mutated	13	8	4	4	29
Polypolish	-i 0.24 -v 0.67 -m 12 -d 19	random	18	18	14	12	62
Polypolish	-i 0.68 -v 0.83 -m 3 -d 3	mutated	12	6	5	3	26
Polypolish	-i 0.28 -v 0.7 -m 13 -d 4	random	13	8	3	4	28
Polypolish	-i 0.68 -v 0.83 -m 2 -d 3	mutated	12	8	4	7	31
Polypolish	-i 0.2 -v 0.95 -m 4 -d 17 --careful	random	18	18	12	11	59
Polypolish	-i 0.68 -v 0.74 -m 3 -d 3 --careful	mutated	10	3	4	1	18
Polypolish	-i 0.34 -v 0.64 -m 1 -d 2 --careful	random	15	5	5	6	31
Polypolish	-i 0.77 -v 0.99 -m 1 -d 16 --careful	random	18	18	17	15	68
Polypolish	-i 0.68 -v 0.74 -m 3 -d 4 --careful	mutated	13	6	4	4	27
Polypolish	-i 0.2 -v 0.48 -m 6 -d 10	random	17	13	8	6	44
Polypolish	-i 0.68 -v 0.74 -m 2 -d 3 --careful	mutated	10	6	4	4	24
Polypolish	-i 0.66 -v 0.72 -m 13 -d 2	random	67	19	7	6	99
Polypolish	-i 0.68 -v 0.73 -m 3 -d 3 --careful	mutated	10	3	4	1	18
Polypolish	-i 0.38 -v 0.5 -m 20 -d 6 --careful	random	17	9	4	4	34
Polypolish	-i 0.68 -v 0.73 -m 2 -d 3 --careful	mutated	10	6	4	4	24
Polypolish	-i 0.23 -v 0.58 -m 3 -d 18	random	18	18	15	12	63
Polypolish	-i 0.73 -v 0.74 -m 3 -d 3 --careful	mutated	10	3	4	1	18
Polypolish	-i 0.47 -v 0.55 -m 17 -d 17 --careful	random	18	17	12	9	56
Polypolish	-i 0.63 -v 0.67 -m 13 -d 8	random	20	17	9	5	51
Polypolish	-i 0.73 -v 0.74 -m 4 -d 3 --careful	mutated	10	5	3	4	22
Polypolish	-i 0.17 -v 0.59 -m 1 -d 15	random	18	17	16	15	66
Polypolish	-i 0.73 -v 0.74 -m 3 -d 3	mutated	14	5	9	3	31
Polypolish	-i 0.61 -v 0.79 -m 0 -d 8 --careful	random	18	18	18	18	72
Polypolish	-i 0.65 -v 0.72 -m 7 -d 3 --careful	random	12	5	3	4	24
Polypolish	-i 0.63 -v 0.67 -m 13 -d 18 --careful	random	18	18	12	10	58
Polypolish	-i 0.74 -v 0.75 -m 3 -d 3 --careful	mutated	10	3	4	1	18
Polypolish	-i 0.62 -v 0.69 -m 18 -d 19	random	18	18	14	13	63
Polypolish	-i 0.74 -v 0.75 -m 4 -d 3 --careful	mutated	10	5	3	4	22
Polypolish	-i 0.23 -v 0.64 -m 15 -d 8 --careful	random	17	10	6	4	37
Polypolish	-i 0.74 -v 0.75 -m 2 -d 3	mutated	14	8	5	7	34
Polypolish	-i 0.45 -v 0.62 -m 8 -d 19	random	18	18	14	12	62
Polypolish	-i 0.69 -v 0.74 -m 3 -d 3	mutated	13	4	6	2	25
Polypolish	-i 0.05 -v 0.32 -m 13 -d 19 --careful	random	18	18	14	12	62
Polypolish	-i 0.74 -v 0.75 -m 3 -d 3	mutated	14	7	10	3	34
Polypolish	-i 0.41 -v 0.52 -m 3 -d 5 --careful	random	14	8	4	4	30
Polypolish	-i 0.75 -v 0.77 -m 4 -d 3	mutated	18	9	8	8	43
Polypolish	-i 0.32 -v 0.65 -m 6 -d 6	random	17	9	4	4	34
Polypolish	-i 0.75 -v 0.79 -m 3 -d 3 --careful	mutated	10	5	4	1	20
Polypolish	-i 0.69 -v 0.74 -m 11 -d 2	random	65	20	8	12	105
Polypolish	-i 0.45 -v 0.79 -m 15 -d 19	random	18	18	14	12	62
Polypolish	-i 0.74 -v 0.75 -m 2 -d 3 --careful	mutated	10	6	4	4	24
Polypolish	-i 0.26 -v 0.61 -m 0 -d 10	random	18	18	18	18	72
Polypolish	-i 0.42 -v 0.56 -m 16 -d 9	random	17	10	7	6	40
Polypolish	-i 0.73 -v 0.75 -m 2 -d 3 --careful	mutated	10	6	4	4	24
Polypolish	-i 0.03 -v 0.3 -m 16 -d 12	random	18	17	12	9	56
Polypolish	-i 0.25 -v 0.51 -m 3 -d 8	random	17	10	6	4	37
Polypolish	-i 0.74 -v 0.8 -m 2 -d 3	mutated	14	8	5	7	34
Polypolish	-i 0.74 -v 0.82 -m 10 -d 1 --careful	random	501	34	18	12	565
Polypolish	-i 0.74 -v 0.82 -m 3 -d 3 --careful	mutated	10	5	4	1	20
Polypolish	-i 0.64 -v 0.92 -m 11 -d 5 --careful	random	14	8	4	4	30
Polypolish	-i 0.74 -v 0.75 -m 4 -d 3	mutated	18	9	8	7	42
Polypolish	-i 0.12 -v 0.24 -m 10 -d 18	random	18	18	12	10	58
Polypolish	-i 0.74 -v 0.78 -m 4 -d 3	mutated	18	9	8	8	43
Polypolish	-i 0.67 -v 0.76 -m 4 -d 19 --careful	random	18	18	15	12	63
Polypolish	-i 0.74 -v 0.75 -m 3 -d 4 --careful	mutated	13	6	4	4	27
Polypolish	-i 0.22 -v 0.66 -m 8 -d 1	random	12	5	4	4	25
Polypolish	-i 0.69 -v 0.75 -m 4 -d 3 --careful	mutated	10	5	3	4	22
Polypolish	-i 0.39 -v 0.47 -m 17 -d 16 --careful	random	18	17	12	9	56
Polypolish	-i 0.74 -v 0.75 -m 3 -d 2	mutated	43	9	10	3	65
Polypolish	-i 0.31 -v 0.65 -m 9 -d 8	random	17	10	6	4	37
Polypolish	-i 0.69 -v 0.75 -m 4 -d 3	mutated	14	7	4	6	31
Polypolish	-i 0.05 -v 0.26 -m 14 -d 9 --careful	random	17	13	10	7	47
Polypolish	-i 0.01 -v 0.56 -m 7 -d 4 --careful	random	18	18	18	18	72
Polypolish	-i 0.22 -v 0.75 -m 20 -d 7	random	17	10	5	4	36
Polypolish	-i 0.43 -v 0.5 -m 15 -d 2	random	25	3	4	0	32
Polypolish	-i 0.71 -v 0.81 -m 3 -d 3 --careful	mutated	10	5	4	1	20
Polypolish	-i 0.56 -v 0.66 -m 11 -d 1 --careful	random	525	34	19	9	587
Polypolish	-i 0.29 -v 0.5 -m 4 -d 18 --careful	random	18	18	14	11	61
Polypolish	-i 0.09 -v 0.87 -m 5 -d 5 --careful	random	17	9	6	4	36
Polypolish	-i 0.75 -v 0.79 -m 4 -d 3 --careful	mutated	10	5	3	4	22
Polypolish	-i 0.38 -v 0.8 -m 18 -d 18	random	18	18	12	10	58
Polypolish	-i 0.28 -v 0.43 -m 16 -d 8 --careful	random	17	10	6	4	37
Polypolish	-i 0.65 -v 0.74 -m 4 -d 3	mutated	13	7	3	5	28
Polypolish	-i 0.24 -v 0.7 -m 18 -d 19	random	18	18	14	12	62
Polypolish	-i 0.27 -v 0.4 -m 1 -d 15	random	18	17	16	15	66
Polypolish	-i 0.64 -v 0.66 -m 11 -d 9	random	17	17	10	7	51
Polypolish	-i 0.73 -v 0.74 -m 3 -d 4	mutated	16	8	10	6	40
Polypolish	-i 0.01 -v 0.87 -m 13 -d 19 --careful	random	18	18	18	18	72
Polypolish	-i 0.73 -v 0.76 -m 20 -d 16 --careful	random	18	17	12	9	56
Polypolish	-i 0.53 -v 0.55 -m 4 -d 6 --careful	random	17	9	4	4	34
Polypolish	-i 0.39 -v 0.98 -m 6 -d 12 --careful	random	17	15	11	8	51
Polypolish	-i 0.23 -v 0.76 -m 3 -d 10 --careful	random	17	14	9	6	46
Polypolish	-i 0.17 -v 0.3 -m 19 -d 7	random	17	10	5	4	36
Polypolish	-i 0.65 -v 0.75 -m 3 -d 3 --careful	mutated	10	3	4	1	18
Polypolish	-i 0.28 -v 0.57 -m 1 -d 3 --careful	random	10	9	6	6	31
Polypolish	-i 0.19 -v 0.69 -m 14 -d 6	random	17	9	5	4	35
Polypolish	-i 0.66 -v 0.69 -m 3 -d 3	mutated	12	4	3	2	21
Polypolish	-i 0.45 -v 0.66 -m 13 -d 4	random	17	8	6	1	32
Polypolish	-i 0.65 -v 0.75 -m 3 -d 3	mutated	12	4	3	2	21
Polypolish	-i 0.45 -v 0.58 -m 19 -d 14	random	18	17	14	9	58
Polypolish	-i 0.31 -v 0.85 -m 18 -d 3 --careful	random	12	5	4	4	25
Polypolish	-i 0.56 -v 0.6 -m 6 -d 13 --careful	random	18	16	11	9	54
Polypolish	-i 0.65 -v 0.75 -m 3 -d 4	mutated	15	7	4	5	31
Polypolish	-i 0.24 -v 0.26 -m 17 -d 7	random	17	10	2	4	33
Polypolish	-i 0.65 -v 0.75 -m 2 -d 3 --careful	mutated	10	6	4	4	24
Polypolish	-i 0.06 -v 0.86 -m 7 -d 4 --careful	random	17	10	8	6	41
Polypolish	-i 0.65 -v 0.85 -m 3 -d 4	mutated	15	9	4	6	34
Polypolish	-i 0.4 -v 0.43 -m 0 -d 18 --careful	random	18	18	18	18	72
Polypolish	-i 0.65 -v 0.82 -m 3 -d 3 --careful	mutated	10	5	4	1	20
Polypolish	-i 0.42 -v 0.58 -m 1 -d 10	random	18	16	13	10	57
Polypolish	-i 0.35 -v 0.65 -m 6 -d 2	random	18	5	3	4	30
Polypolish	-i 0.75 -v 0.75 -m 3 -d 3	mutated	inf	inf	inf	inf	inf
Polypolish	-i 0.36 -v 0.78 -m 5 -d 16 --careful	random	18	17	12	10	57
Polypolish	-i 0.32 -v 0.55 -m 6 -d 7	random	17	10	5	4	36
Polypolish	-i 0.65 -v 0.75 -m 3 -d 2	mutated	41	6	3	2	52
Polypolish	-i 0.67 -v 0.7 -m 3 -d 3	random	12	4	4	2	22
Polypolish	-i 0.7 -v 0.83 -m 3 -d 3	mutated	14	7	6	4	31
Polypolish	-i 0.33 -v 0.74 -m 17 -d 17	random	18	17	12	9	56
Polypolish	-i 0.46 -v 0.56 -m 12 -d 9	random	17	11	10	6	44
Polypolish	-i 0.59 -v 0.71 -m 10 -d 17	random	18	17	12	10	57
Polypolish	-i 0.65 -v 0.81 -m 3 -d 3 --careful	mutated	10	5	4	1	20
Polypolish	-i 0.31 -v 0.55 -m 6 -d 9	random	17	10	7	6	40
Polypolish	-i 0.22 -v 0.58 -m 19 -d 11	random	17	13	9	7	46
Polypolish	-i 0.63 -v 0.66 -m 4 -d 6 --careful	random	17	9	4	4	34
Polypolish	-i 0.21 -v 0.27 -m 1 -d 5	random	15	12	8	6	41
Polypolish	-i 0.38 -v 0.57 -m 7 -d 6	random	17	9	4	4	34
Polypolish	-i 0.18 -v 0.96 -m 15 -d 2	random	12	5	5	4	26
Polypolish	-i 0.65 -v 0.82 -m 3 -d 4	mutated	15	9	4	6	34
Polypolish	-i 0.61 -v 0.61 -m 1 -d 6	random	inf	inf	inf	inf	inf
Polypolish	-i 0.65 -v 0.75 -m 4 -d 3 --careful	mutated	10	5	3	4	22
Polypolish	-i 0.59 -v 0.76 -m 6 -d 18	random	18	18	13	12	61
Polypolish	-i 0.08 -v 0.66 -m 20 -d 13	random	17	16	11	9	53
Polypolish	-i 0.75 -v 0.75 -m 2 -d 2	mutated	inf	inf	inf	inf	inf
Polypolish	-i 0.26 -v 0.55 -m 5 -d 14	random	18	17	12	9	56
Polypolish	-i 0.24 -v 0.27 -m 13 -d 4 --careful	random	13	8	1	4	26
Polypolish	-i 0.27 -v 0.32 -m 17 -d 1	random	20	4	0	3	27
Polypolish	-i 0.56 -v 0.75 -m 3 -d 3 --careful	mutated	10	3	4	1	18
Polypolish	-i 0.42 -v 0.66 -m 9 -d 9	random	17	10	7	6	40
Polypolish	-i 0.53 -v 0.75 -m 3 -d 3 --careful	mutated	10	3	4	1	18
Polypolish	-i 0.71 -v 0.8 -m 9 -d 2 --careful	random	51	10	5	4	70
Polypolish	-i 0.53 -v 0.73 -m 2 -d 4 --careful	mutated	13	8	4	4	29
Polypolish	-i 0.07 -v 0.26 -m 18 -d 12 --careful	random	17	15	11	8	51
Polypolish	-i 0.53 -v 0.75 -m 4 -d 3	mutated	11	5	3	3	22
Polypolish	-i 0.74 -v 0.87 -m 14 -d 19	random	18	18	15	15	66
Polypolish	-i 0.53 -v 0.75 -m 4 -d 3 --careful	mutated	10	5	3	4	22
Polypolish	-i 0.35 -v 0.53 -m 3 -d 15	random	18	17	12	9	56
Polypolish	-i 0.54 -v 0.74 -m 3 -d 4 --careful	mutated	13	6	4	4	27
Polypolish	-i 0.42 -v 0.52 -m 6 -d 5 --careful	random	14	6	4	4	28
Polypolish	-i 0.29 -v 0.65 -m 14 -d 6 --careful	random	17	9	4	4	34
Polypolish	-i 0.53 -v 0.75 -m 3 -d 4 --careful	mutated	13	6	4	4	27
Polypolish	-i 0.53 -v 0.82 -m 18 -d 18	random	18	18	12	10	58
Polypolish	-i 0.53 -v 0.75 -m 3 -d 3	mutated	11	3	3	1	18
Polypolish	-i 0.13 -v 0.87 -m 6 -d 18	random	18	18	13	11	60
Polypolish	-i 0.18 -v 0.96 -m 6 -d 6	random	17	9	5	4	35
Polypolish	-i 0.44 -v 0.95 -m 16 -d 4	random	17	9	5	4	35
Polypolish	-i 0.53 -v 0.75 -m 2 -d 3 --careful	mutated	10	6	4	4	24
Polypolish	-i 0.49 -v 0.96 -m 10 -d 5	random	18	9	8	4	39
Polypolish	-i 0.53 -v 0.75 -m 2 -d 3	mutated	11	6	4	4	25
Polypolish	-i 0.68 -v 0.81 -m 19 -d 13	random	17	16	13	17	63
Polypolish	-i 0.29 -v 0.38 -m 3 -d 4	random	13	8	4	3	28
Polypolish	-i 0.07 -v 0.59 -m 18 -d 2 --careful	random	17	10	7	4	38
Polypolish	-i 0.53 -v 0.75 -m 3 -d 2 --careful	mutated	39	5	4	0	48
Polypolish	-i 0.55 -v 0.61 -m 13 -d 9 --careful	random	17	10	7	6	40
Polypolish	-i 0.36 -v 0.39 -m 14 -d 16	random	18	17	12	9	56
Polypolish	-i 0.48 -v 0.75 -m 4 -d 3 --careful	mutated	10	5	3	4	22
Polypolish	-i 0.51 -v 0.83 -m 5 -d 8	random	17	10	6	4	37
Polypolish	-i 0.35 -v 0.36 -m 13 -d 19 --careful	random	18	18	14	12	62
Polypolish	-i 0.11 -v 0.24 -m 15 -d 1 --careful	random	14	8	5	4	31
Polypolish	-i 0.45 -v 0.76 -m 1 -d 4 --careful	random	13	11	6	6	36
Polypolish	-i 0.49 -v 0.72 -m 3 -d 2	mutated	16	3	3	0	22
Polypolish	-i 0.22 -v 0.43 -m 19 -d 3 --careful	random	12	5	1	4	22
Polypolish	-i 0.53 -v 0.75 -m 3 -d 4	mutated	14	6	4	4	28
Polypolish	-i 0.18 -v 0.93 -m 0 -d 7	random	18	18	18	18	72
Polypolish	-i 0.47 -v 0.75 -m 3 -d 4	mutated	14	6	4	3	27
Polypolish	-i 0.24 -v 0.79 -m 2 -d 8 --careful	random	17	12	7	4	40
Polypolish	-i 0.46 -v 0.75 -m 3 -d 3	mutated	11	3	3	0	17
Polypolish	-i 0.27 -v 0.76 -m 18 -d 15	random	18	17	12	9	56
Polypolish	-i 0.46 -v 0.74 -m 9 -d 11 --careful	random	17	13	9	7	46
Polypolish	-i 0.71 -v 0.73 -m 10 -d 8 --careful	random	17	10	6	4	37
Polypolish	-i 0.46 -v 0.75 -m 3 -d 3 --careful	mutated	10	3	4	1	18
Polypolish	-i 0.52 -v 0.9 -m 1 -d 6	random	17	12	8	6	43
Polypolish	-i 0.46 -v 0.74 -m 3 -d 3 --careful	mutated	10	3	4	1	18
Polypolish	-i 0.59 -v 0.98 -m 19 -d 2	random	29	9	9	5	52
Polypolish	-i 0.3 -v 0.71 -m 3 -d 17	random	18	18	12	11	59
Polypolish	-i 0.46 -v 0.75 -m 2 -d 2 --careful	mutated	14	4	4	4	26
Polypolish	-i 0.01 -v 0.61 -m 6 -d 9	random	18	18	18	18	72
Polypolish	-i 0.42 -v 0.7 -m 3 -d 3	mutated	11	3	3	0	17
Polypolish	-i 0.72 -v 0.85 -m 1 -d 19	random	18	18	17	17	70
Polypolish	-i 0.37 -v 0.7 -m 3 -d 3	mutated	11	5	4	0	20
Polypolish	-i 0.46 -v 0.84 -m 12 -d 15	random	18	17	12	9	56
Polypolish	-i 0.42 -v 0.61 -m 2 -d 2 --careful	mutated	14	4	4	4	26
Polypolish	-i 0.73 -v 0.94 -m 13 -d 8 --careful	random	17	10	6	4	37
Polypolish	-i 0.33 -v 0.73 -m 3 -d 3	mutated	11	5	4	0	20
Polypolish	-i 0.68 -v 0.69 -m 1 -d 16	random	18	18	17	15	68
Polypolish	-i 0.61 -v 0.92 -m 11 -d 11	random	17	15	12	8	52
Polypolish	-i 0.33 -v 0.74 -m 2 -d 3 --careful	mutated	10	6	4	4	24
Polypolish	-i 0.21 -v 0.5 -m 20 -d 6 --careful	random	17	9	5	4	35
Polypolish	-i 0.42 -v 0.7 -m 3 -d 4 --careful	mutated	13	6	4	4	27
Polypolish	-i 0.34 -v 0.86 -m 10 -d 12	random	17	15	10	8	50
Polypolish	-i 0.42 -v 0.7 -m 3 -d 2	mutated	16	3	3	0	22
Polypolish	-i 0.62 -v 0.76 -m 3 -d 14	random	18	17	12	11	58
Polypolish	-i 0.42 -v 0.78 -m 3 -d 3 --careful	mutated	10	5	4	1	20
Polypolish	-i 0.21 -v 0.9 -m 12 -d 18	random	18	18	12	10	58
Polypolish	-i 0.42 -v 0.61 -m 3 -d 3 --careful	mutated	10	3	4	1	18
Polypolish	-i 0.21 -v 0.61 -m 15 -d 16	random	18	17	12	9	56
Polypolish	-i 0.45 -v 0.7 -m 2 -d 3 --careful	mutated	10	6	4	4	24
Polypolish	-i 0.7 -v 0.75 -m 18 -d 6 --careful	random	17	9	4	4	34
Polypolish	-i 0.42 -v 0.7 -m 4 -d 3 --careful	mutated	10	5	3	4	22
Polypolish	-i 0.28 -v 0.9 -m 10 -d 18	random	18	18	12	10	58
Polypolish	-i 0.42 -v 0.7 -m 2 -d 3	mutated	11	6	4	4	25
Polypolish	-i 0.27 -v 0.27 -m 2 -d 13 --careful	random	inf	inf	inf	inf	inf
Polypolish	-i 0.51 -v 0.7 -m 3 -d 3 --careful	mutated	10	3	4	1	18
Polypolish	-i 0.26 -v 0.89 -m 14 -d 4	random	13	8	4	4	29
Polypolish	-i 0.42 -v 0.7 -m 2 -d 3 --careful	mutated	10	6	4	4	24
Polypolish	-i 0.51 -v 0.92 -m 6 -d 3 --careful	random	10	5	4	4	23
Polypolish	-i 0.42 -v 0.8 -m 3 -d 3 --careful	mutated	10	5	4	1	20
Polypolish	-i 0.39 -v 0.66 -m 17 -d 6	random	17	9	4	4	34
Polypolish	-i 0.21 -v 0.22 -m 12 -d 6	random	17	9	5	4	35
Polypolish	-i 0.09 -v 0.72 -m 13 -d 12 --careful	random	17	15	11	8	51
Polypolish	-i 0.59 -v 0.73 -m 3 -d 10	random	17	14	9	7	47
Polypolish	-i 0.42 -v 0.7 -m 3 -d 3 --careful	mutated	10	3	4	1	18
Polypolish	-i 0.23 -v 0.84 -m 4 -d 19	random	18	18	15	12	63
Polypolish	-i 0.42 -v 0.75 -m 3 -d 3	mutated	11	3	3	0	17
Polypolish	-i 0.38 -v 0.96 -m 1 -d 12	random	18	17	16	13	64
Polypolish	-i 0.47 -v 0.74 -m 7 -d 16 --careful	random	18	17	12	10	57
Polypolish	-i 0.42 -v 0.75 -m 3 -d 3 --careful	mutated	10	3	4	1	18
Polypolish	-i 0.59 -v 0.61 -m 20 -d 8	random	20	14	9	5	48
Polypolish	-i 0.61 -v 0.76 -m 0 -d 18 --careful	random	18	18	18	18	72
Polypolish	-i 0.42 -v 0.75 -m 2 -d 2	mutated	15	4	4	4	27
Polypolish	-i 0.48 -v 0.53 -m 19 -d 16 --careful	random	18	17	12	9	56
Polypolish	-i 0.42 -v 0.75 -m 2 -d 3 --careful	mutated	10	6	4	4	24
Polypolish	-i 0.1 -v 0.25 -m 15 -d 9	random	17	10	8	6	41
Polypolish	-i 0.38 -v 0.75 -m 2 -d 3	mutated	11	6	4	4	25
Polypolish	-i 0.02 -v 0.8 -m 10 -d 10 --careful	random	18	18	17	17	70
Polypolish	-i 0.42 -v 0.75 -m 3 -d 4	mutated	14	6	4	3	27
Polypolish	-i 0.1 -v 0.82 -m 18 -d 5 --careful	random	17	9	6	4	36
Polypolish	-i 0.41 -v 0.75 -m 3 -d 3 --careful	mutated	10	5	4	1	20
Polypolish	-i 0.18 -v 0.71 -m 7 -d 3	random	11	5	5	4	25
Polypolish	-i 0.39 -v 0.78 -m 3 -d 3	mutated	11	5	3	1	20
Polypolish	-i 0.65 -v 0.7 -m 0 -d 11 --careful	random	18	18	18	18	72
Polypolish	-i 0.42 -v 0.73 -m 3 -d 3 --careful	mutated	10	3	4	1	18
Polypolish	-i 0.68 -v 0.77 -m 15 -d 5	random	24	18	7	12	61
Polypolish	-i 0.42 -v 0.75 -m 3 -d 2	mutated	16	3	3	0	22
Polypolish	-i 0.18 -v 0.89 -m 8 -d 13	random	17	16	10	9	52
Polypolish	-i 0.42 -v 0.68 -m 3 -d 3	mutated	11	3	3	0	17
Polypolish	-i 0.12 -v 0.96 -m 18 -d 19 --careful	random	18	18	14	12	62
Polypolish	-i 0.42 -v 0.68 -m 3 -d 3 --careful	mutated	10	3	4	1	18
Polypolish	-i 0.36 -v 0.92 -m 3 -d 14	random	18	17	12	9	56
Polypolish	-i 0.37 -v 0.68 -m 3 -d 4 --careful	mutated	13	8	4	4	29
Polypolish	-i 0.3 -v 0.89 -m 20 -d 16 --careful	random	18	17	12	9	56
Polypolish	-i 0.28 -v 0.75 -m 3 -d 13 --careful	random	18	17	11	9	55
Polypolish	-i 0.45 -v 0.68 -m 3 -d 3	mutated	11	3	3	0	17
Polypolish	-i 0.37 -v 0.75 -m 5 -d 17	random	18	18	12	10	58
Polypolish	-i 0.49 -v 0.68 -m 3 -d 3	mutated	11	3	3	0	17
Polypolish	-i 0.69 -v 0.79 -m 9 -d 8 --careful	random	17	10	6	4	37
Polypolish	-i 0.49 -v 0.63 -m 3 -d 2 --careful	mutated	15	3	4	1	23
Polypolish	-i 0.71 -v 0.83 -m 4 -d 6	random	17	11	6	7	41
Polypolish	-i 0.49 -v 0.68 -m 2 -d 3	mutated	11	6	4	3	24
Polypolish	-i 0.25 -v 0.46 -m 20 -d 10	random	17	13	7	6	43
Polypolish	-i 0.49 -v 0.68 -m 3 -d 3 --careful	mutated	10	3	4	1	18
Polypolish	-i 0.36 -v 0.57 -m 10 -d 20	random	18	18	15	12	63
Polypolish	-i 0.05 -v 0.42 -m 0 -d 15	random	18	18	18	18	72
Polypolish	-i 0.49 -v 0.68 -m 3 -d 2	mutated	16	3	3	0	22
Polypolish	-i 0.57 -v 0.65 -m 12 -d 20 --careful	random	18	18	15	12	63
Polypolish	-i 0.23 -v 0.5 -m 13 -d 18 --careful	random	18	18	12	10	58
Polypolish	-i 0.49 -v 0.74 -m 2 -d 3 --careful	mutated	10	6	4	4	24
Polypolish	-i 0.3 -v 0.46 -m 3 -d 6 --careful	random	17	9	4	4	34
Polypolish	-i 0.49 -v 0.74 -m 3 -d 3	mutated	11	3	3	0	17
Polypolish	-i 0.58 -v 0.75 -m 13 -d 1	random	524	31	10	5	570
Polypolish	-i 0.44 -v 0.7 -m 3 -d 3 --careful	mutated	10	3	4	1	18
Polypolish	-i 0.13 -v 0.66 -m 3 -d 12 --careful	random	18	15	11	8	52
Polypolish	-i 0.41 -v 0.65 -m 3 -d 2	mutated	16	5	3	0	24
Polypolish	-i 0.39 -v 0.98 -m 15 -d 5 --careful	random	14	8	6	4	32
Polypolish	-i 0.39 -v 0.78 -m 3 -d 3 --careful	mutated	10	5	4	1	20
Polypolish	-i 0.58 -v 0.8 -m 9 -d 15 --careful	random	18	17	12	9	56
Polypolish	-i 0.49 -v 0.74 -m 3 -d 2	mutated	16	3	3	0	22
Polypolish	-i 0.09 -v 0.55 -m 16 -d 17 --careful	random	18	17	12	9	56
Polypolish	-i 0.36 -v 0.57 -m 20 -d 17 --careful	random	18	17	12	9	56
Polypolish	-i 0.49 -v 0.74 -m 2 -d 3	mutated	11	6	4	4	25
Polypolish	-i 0.52 -v 0.54 -m 14 -d 20	random	18	18	15	12	63
Polypolish	-i 0.23 -v 0.27 -m 8 -d 6 --careful	random	17	9	4	4	34
Polypolish	-i 0.49 -v 0.74 -m 3 -d 3 --careful	mutated	10	3	4	1	18
Polypolish	-i 0.3 -v 0.61 -m 18 -d 17 --careful	random	18	17	12	9	56
Polypolish	-i 0.49 -v 0.74 -m 3 -d 4	mutated	14	6	4	3	27
Polypolish	-i 0.62 -v 0.93 -m 13 -d 14	random	18	17	14	10	59
Polypolish	-i 0.49 -v 0.69 -m 3 -d 4	mutated	14	6	4	3	27
Polypolish	-i 0.58 -v 0.79 -m 6 -d 8 --careful	random	17	10	6	4	37
Polypolish	-i 0.42 -v 0.71 -m 3 -d 3 --careful	mutated	10	3	4	1	18
Polypolish	-i 0.02 -v 0.89 -m 19 -d 15 --careful	random	18	18	17	17	70
Polypolish	-i 0.49 -v 0.74 -m 4 -d 4	mutated	14	8	3	3	28
Polypolish	-i 0.18 -v 0.55 -m 11 -d 3 --careful	random	12	5	5	4	26
Polypolish	-i 0.2 -v 0.46 -m 2 -d 17 --careful	random	18	18	14	14	64
Polypolish	-i 0.22 -v 0.81 -m 4 -d 12 --careful	random	17	15	11	8	51
Polypolish	-i 0.49 -v 0.72 -m 3 -d 4	mutated	14	6	4	3	27
Polypolish	-i 0.03 -v 0.87 -m 0 -d 19	random	18	18	18	18	72
Pypolca	--min_alt 2 --min_ratio 2.0	defaults	53	8	2	0	63
Pypolca	--min_alt 4 --min_ratio 3.0	careful mode	12	5	0	0	17
Pypolca	--min_alt 24 --min_ratio 5.57	random	18	18	16	15	67
Pypolca	--min_alt 3 --min_ratio 2.93	mutated	12	3	0	0	15
Pypolca	--min_alt 23 --min_ratio 2.03	random	18	18	15	15	66
Pypolca	--min_alt 4 --min_ratio 2.99	mutated	12	5	0	0	17
Pypolca	--min_alt 2 --min_ratio 16.6	random	13	3	3	1	20
Pypolca	--min_alt 3 --min_ratio 2.92	mutated	12	3	0	0	15
Pypolca	--min_alt 3 --min_ratio 1.72	random	12	3	0	0	15
Pypolca	--min_alt 12 --min_ratio 8.15	random	17	15	10	8	50
Pypolca	--min_alt 2 --min_ratio 1.4	random	54	8	2	0	64
Pypolca	--min_alt 18 --min_ratio 4.16	random	18	18	12	10	58
Pypolca	--min_alt 3 --min_ratio 1.7	mutated	12	3	0	0	15
Pypolca	--min_alt 15 --min_ratio 1.37	random	18	17	11	9	55
Pypolca	--min_alt 4 --min_ratio 1.75	mutated	12	5	0	0	17
Pypolca	--min_alt 3 --min_ratio 6.87	random	11	3	0	1	15
Pypolca	--min_alt 2 --min_ratio 6.93	mutated	13	3	0	1	17
Pypolca	--min_alt 8 --min_ratio 5.91	random	17	10	6	4	37
Pypolca	--min_alt 2 --min_ratio 6.87	mutated	13	3	0	1	17
Pypolca	--min_alt 10 --min_ratio 6.83	random	17	13	7	6	43
Pypolca	--min_alt 25 --min_ratio 0.52	random	18	18	17	16	69
Pypolca	--min_alt 8 --min_ratio 4.35	random	17	10	6	4	37
Pypolca	--min_alt 2 --min_ratio 6.79	mutated	13	3	0	1	17
Pypolca	--min_alt 2 --min_ratio 14.07	random	13	3	3	1	20
Pypolca	--min_alt 2 --min_ratio 6.8	mutated	13	3	0	1	17
Pypolca	--min_alt 12 --min_ratio 13.66	random	17	15	10	8	50
Pypolca	--min_alt 4 --min_ratio 6.87	mutated	12	5	0	1	18
Pypolca	--min_alt 18 --min_ratio 2.78	random	18	18	12	10	58
Pypolca	--min_alt 3 --min_ratio 6.83	mutated	11	3	0	1	15
Pypolca	--min_alt 16 --min_ratio 2.15	random	18	17	11	9	55
Pypolca	--min_alt 3 --min_ratio 6.75	mutated	11	3	0	1	15
Pypolca	--min_alt 7 --min_ratio 14.14	random	17	10	6	4	37
Pypolca	--min_alt 11 --min_ratio 6.23	random	17	13	8	6	44
Pypolca	--min_alt 2 --min_ratio 6.75	mutated	13	3	0	1	17
Pypolca	--min_alt 17 --min_ratio 1.19	random	18	17	11	9	55
Pypolca	--min_alt 4 --min_ratio 6.75	mutated	12	5	0	1	18
Pypolca	--min_alt 4 --min_ratio 5.01	random	12	5	0	1	18
Pypolca	--min_alt 4 --min_ratio 6.67	mutated	12	5	0	1	18
Pypolca	--min_alt 23 --min_ratio 11.51	random	18	18	15	15	66
Pypolca	--min_alt 4 --min_ratio 6.77	mutated	12	5	0	1	18
Pypolca	--min_alt 16 --min_ratio 0.84	random	18	17	11	9	55
Pypolca	--min_alt 3 --min_ratio 6.76	mutated	11	3	0	1	15
Pypolca	--min_alt 26 --min_ratio 1.38	random	18	18	17	16	69
Pypolca	--min_alt 4 --min_ratio 6.84	mutated	12	5	0	1	18
Pypolca	--min_alt 13 --min_ratio 7.59	random	17	16	10	9	52
Pypolca	--min_alt 2 --min_ratio 6.76	mutated	13	3	0	1	17
Pypolca	--min_alt 3 --min_ratio 0.97	random	16	3	1	1	21
Pypolca	--min_alt 3 --min_ratio 6.68	mutated	11	3	0	1	15
Pypolca	--min_alt 6 --min_ratio 20.39	random	17	8	3	1	29
Pypolca	--min_alt 4 --min_ratio 6.68	mutated	12	5	0	1	18
Pypolca	--min_alt 22 --min_ratio 0.57	random	18	18	15	15	66
Pypolca	--min_alt 10 --min_ratio 13.33	random	17	13	7	6	43
Pypolca	--min_alt 3 --min_ratio 6.62	mutated	11	3	0	1	15
Pypolca	--min_alt 13 --min_ratio 15.83	random	17	16	10	9	52
Pypolca	--min_alt 1 --min_ratio 1.0	random	118	18	5	1	142
Pypolca	--min_alt 26 --min_ratio 16.2	random	18	18	17	16	69
Pypolca	--min_alt 1 --min_ratio 5.18	random	13	3	0	1	17
Pypolca	--min_alt 7 --min_ratio 1.01	random	17	10	3	4	34
Pypolca	--min_alt 2 --min_ratio 6.69	mutated	13	3	0	1	17
Pypolca	--min_alt 23 --min_ratio 3.87	random	18	18	15	15	66
Pypolca	--min_alt 23 --min_ratio 13.41	random	18	18	15	15	66
Pypolca	--min_alt 17 --min_ratio 12.0	random	18	17	11	9	55
Pypolca	--min_alt 4 --min_ratio 6.64	mutated	12	5	0	1	18
Pypolca	--min_alt 8 --min_ratio 2.37	random	17	10	6	4	37
Pypolca	--min_alt 4 --min_ratio 6.62	mutated	12	5	0	1	18
Pypolca	--min_alt 12 --min_ratio 15.35	random	17	15	10	8	50
Pypolca	--min_alt 4 --min_ratio 6.56	mutated	12	5	0	1	18
Pypolca	--min_alt 1 --min_ratio 5.88	random	13	3	0	1	17
Pypolca	--min_alt 20 --min_ratio 20.77	random	18	18	15	12	63
Pypolca	--min_alt 26 --min_ratio 14.88	random	18	18	17	16	69
Pypolca	--min_alt 13 --min_ratio 0.58	random	17	16	10	9	52
Pypolca	--min_alt 4 --min_ratio 6.61	mutated	12	5	0	1	18
Pypolca	--min_alt 2 --min_ratio 2.78	random	14	3	0	0	17
Pypolca	--min_alt 3 --min_ratio 6.59	mutated	11	3	0	1	15
Pypolca	--min_alt 1 --min_ratio 18.95	random	13	3	3	1	20
Pypolca	--min_alt 4 --min_ratio 6.59	mutated	12	5	0	1	18
Pypolca	--min_alt 7 --min_ratio 6.96	random	17	10	3	4	34
Pypolca	--min_alt 20 --min_ratio 16.21	random	18	18	15	12	63
Pypolca	--min_alt 3 --min_ratio 6.61	mutated	11	3	0	1	15
Pypolca	--min_alt 14 --min_ratio 0.75	random	18	17	10	9	54
Pypolca	--min_alt 3 --min_ratio 6.67	mutated	11	3	0	1	15
Pypolca	--min_alt 17 --min_ratio 3.03	random	18	17	11	9	55
Pypolca	--min_alt 10 --min_ratio 14.29	random	17	13	7	6	43
Pypolca	--min_alt 18 --min_ratio 5.22	random	18	18	12	10	58
Pypolca	--min_alt 17 --min_ratio 25.81	random	18	17	11	9	55
Pypolca	--min_alt 2 --min_ratio 9.37	random	13	3	3	1	20
Pypolca	--min_alt 2 --min_ratio 2.22	random	14	3	0	0	17
Pypolca	--min_alt 3 --min_ratio 6.71	mutated	11	3	0	1	15
Pypolca	--min_alt 14 --min_ratio 7.88	random	18	17	10	9	54
Pypolca	--min_alt 15 --min_ratio 2.5	random	18	17	11	9	55
Pypolca	--min_alt 2 --min_ratio 13.62	random	13	3	3	1	20
Pypolca	--min_alt 2 --min_ratio 6.71	mutated	13	3	0	1	17
Pypolca	--min_alt 2 --min_ratio 10.97	random	13	3	3	1	20
Pypolca	--min_alt 3 --min_ratio 6.66	mutated	11	3	0	1	15
Pypolca	--min_alt 15 --min_ratio 9.38	random	18	17	11	9	55
Pypolca	--min_alt 9 --min_ratio 4.01	random	17	10	7	5	39
Pypolca	--min_alt 4 --min_ratio 11.62	random	12	5	3	1	21
Pypolca	--min_alt 4 --min_ratio 6.69	mutated	12	5	0	1	18
Pypolca	--min_alt 6 --min_ratio 1.34	random	17	8	0	1	26
Pypolca	--min_alt 3 --min_ratio 6.72	mutated	11	3	0	1	15
Pypolca	--min_alt 2 --min_ratio 0.65	random	183	58	20	3	264
Pypolca	--min_alt 1 --min_ratio 20.05	random	13	3	3	1	20
Pypolca	--min_alt 4 --min_ratio 6.74	mutated	12	5	0	1	18
Pypolca	--min_alt 2 --min_ratio 6.15	random	13	3	0	1	17
Pypolca	--min_alt 11 --min_ratio 24.9	random	17	13	8	6	44
Pypolca	--min_alt 2 --min_ratio 6.63	mutated	13	3	0	1	17
Pypolca	--min_alt 24 --min_ratio 10.21	random	18	18	16	15	67
Pypolca	--min_alt 4 --min_ratio 1.18	random	12	5	0	0	17
Pypolca	--min_alt 3 --min_ratio 6.79	mutated	11	3	0	1	15
Pypolca	--min_alt 6 --min_ratio 19.19	random	17	8	3	1	29
Pypolca	--min_alt 23 --min_ratio 2.2	random	18	18	15	15	66
Pypolca	--min_alt 4 --min_ratio 6.79	mutated	12	5	0	1	18
Pypolca	--min_alt 11 --min_ratio 2.33	random	17	13	8	6	44
Pypolca	--min_alt 4 --min_ratio 6.81	mutated	12	5	0	1	18
Pypolca	--min_alt 4 --min_ratio 0.66	random	12	5	2	3	22
Pypolca	--min_alt 2 --min_ratio 3.72	random	13	3	0	0	16
Pypolca	--min_alt 3 --min_ratio 6.8	mutated	11	3	0	1	15
Pypolca	--min_alt 8 --min_ratio 15.26	random	17	10	6	4	37
Pypolca	--min_alt 7 --min_ratio 21.61	random	17	10	6	4	37
Pypolca	--min_alt 10 --min_ratio 4.6	random	17	13	7	6	43
Pypolca	--min_alt 25 --min_ratio 0.96	random	18	18	17	16	69
Pypolca	--min_alt 4 --min_ratio 6.8	mutated	12	5	0	1	18
Pypolca	--min_alt 2 --min_ratio 6.19	random	13	3	0	1	17
Pypolca	--min_alt 18 --min_ratio 6.35	random	18	18	12	10	58
Pypolca	--min_alt 17 --min_ratio 9.88	random	18	17	11	9	55
Pypolca	--min_alt 1 --min_ratio 3.67	random	13	3	0	0	16
Pypolca	--min_alt 19 --min_ratio 8.39	random	18	18	13	11	60
Pypolca	--min_alt 2 --min_ratio 11.28	random	13	3	3	1	20
Pypolca	--min_alt 2 --min_ratio 6.82	mutated	13	3	0	1	17
Pypolca	--min_alt 12 --min_ratio 5.47	random	17	15	10	8	50
Pypolca	--min_alt 3 --min_ratio 4.53	random	11	3	0	0	14
Pypolca	--min_alt 2 --min_ratio 4.53	mutated	13	3	0	0	16
Pypolca	--min_alt 25 --min_ratio 16.95	random	18	18	17	16	69
Pypolca	--min_alt 7 --min_ratio 11.27	random	17	10	6	4	37
Pypolca	--min_alt 4 --min_ratio 4.56	mutated	12	5	0	0	17
Pypolca	--min_alt 4 --min_ratio 3.87	random	12	5	0	0	17
Pypolca	--min_alt 2 --min_ratio 4.61	mutated	13	3	0	0	16
Pypolca	--min_alt 3 --min_ratio 22.32	random	11	3	3	1	18
Pypolca	--min_alt 2 --min_ratio 12.02	random	13	3	3	1	20
Pypolca	--min_alt 4 --min_ratio 4.43	mutated	12	5	0	0	17
Pypolca	--min_alt 2 --min_ratio 5.0	random	13	3	0	0	16
Pypolca	--min_alt 16 --min_ratio 3.94	random	18	17	11	9	55
Pypolca	--min_alt 2 --min_ratio 4.46	mutated	13	3	0	0	16
Pypolca	--min_alt 4 --min_ratio 20.62	random	12	5	3	1	21
Pypolca	--min_alt 11 --min_ratio 10.66	random	17	13	8	6	44
Pypolca	--min_alt 4 --min_ratio 4.48	mutated	12	5	0	0	17
Pypolca	--min_alt 7 --min_ratio 2.03	random	17	10	3	4	34
Pypolca	--min_alt 3 --min_ratio 4.47	mutated	11	3	0	0	14
Pypolca	--min_alt 8 --min_ratio 14.4	random	17	10	6	4	37
Pypolca	--min_alt 3 --min_ratio 4.45	mutated	11	3	0	0	14
Pypolca	--min_alt 9 --min_ratio 9.1	random	17	10	7	5	39
Pypolca	--min_alt 4 --min_ratio 4.42	mutated	12	5	0	0	17
Pypolca	--min_alt 3 --min_ratio 13.57	random	11	3	3	1	18
Pypolca	--min_alt 4 --min_ratio 4.45	mutated	12	5	0	0	17
Pypolca	--min_alt 15 --min_ratio 7.8	random	18	17	11	9	55
Pypolca	--min_alt 3 --min_ratio 4.4	mutated	11	3	0	0	14
Pypolca	--min_alt 26 --min_ratio 5.64	random	18	18	17	16	69
Pypolca	--min_alt 4 --min_ratio 4.46	mutated	12	5	0	0	17
Pypolca	--min_alt 11 --min_ratio 4.22	random	17	13	8	6	44
Pypolca	--min_alt 19 --min_ratio 15.01	random	18	18	13	11	60
Pypolca	--min_alt 19 --min_ratio 3.39	random	18	18	13	11	60
Pypolca	--min_alt 2 --min_ratio 4.41	mutated	13	3	0	0	16
Pypolca	--min_alt 3 --min_ratio 20.93	random	11	3	3	1	18
Pypolca	--min_alt 4 --min_ratio 4.36	mutated	12	5	0	0	17
Pypolca	--min_alt 10 --min_ratio 1.43	random	17	13	7	6	43
Pypolca	--min_alt 2 --min_ratio 4.33	mutated	13	3	0	0	16
Pypolca	--min_alt 21 --min_ratio 0.9	random	18	18	15	13	64
Pypolca	--min_alt 20 --min_ratio 26.44	random	18	18	15	12	63
Pypolca	--min_alt 2 --min_ratio 4.32	mutated	13	3	0	0	16
Pypolca	--min_alt 3 --min_ratio 8.83	random	11	3	3	1	18
Pypolca	--min_alt 8 --min_ratio 0.69	random	17	10	6	4	37
Pypolca	--min_alt 1 --min_ratio 20.67	random	13	3	3	1	20
Pypolca	--min_alt 2 --min_ratio 4.4	mutated	13	3	0	0	16
Pypolca	--min_alt 2 --min_ratio 5.86	random	13	3	0	1	17
Pypolca	--min_alt 3 --min_ratio 1.25	random	13	3	0	0	16
Pypolca	--min_alt 4 --min_ratio 0.53	random	13	8	3	5	29
Pypolca	--min_alt 4 --min_ratio 4.47	mutated	12	5	0	0	17
Pypolca	--min_alt 23 --min_ratio 9.11	random	18	18	15	15	66
Pypolca	--min_alt 12 --min_ratio 3.61	random	17	15	10	8	50
Pypolca	--min_alt 24 --min_ratio 21.71	random	18	18	16	15	67
Pypolca	--min_alt 21 --min_ratio 5.96	random	18	18	15	13	64
Pypolca	--min_alt 2 --min_ratio 7.54	random	13	3	3	1	20
Pypolca	--min_alt 3 --min_ratio 12.58	random	11	3	3	1	18
Pypolca	--min_alt 19 --min_ratio 6.93	random	18	18	13	11	60
Pypolca	--min_alt 5 --min_ratio 3.91	random	13	6	0	0	19
Pypolca	--min_alt 2 --min_ratio 24.76	random	13	3	3	1	20
Pypolca	--min_alt 4 --min_ratio 4.4	mutated	12	5	0	0	17
Pypolca	--min_alt 15 --min_ratio 21.08	random	18	17	11	9	55
Pypolca	--min_alt 3 --min_ratio 4.42	mutated	11	3	0	0	14
Pypolca	--min_alt 21 --min_ratio 1.87	random	18	18	15	13	64
Pypolca	--min_alt 4 --min_ratio 5.24	random	12	5	0	1	18
Pypolca	--min_alt 3 --min_ratio 1.13	random	13	3	0	0	16
Pypolca	--min_alt 3 --min_ratio 4.48	mutated	11	3	0	0	14
Pypolca	--min_alt 2 --min_ratio 13.78	random	13	3	3	1	20
Pypolca	--min_alt 12 --min_ratio 17.39	random	17	15	10	8	50
Pypolca	--min_alt 2 --min_ratio 4.48	mutated	13	3	0	0	16
Pypolca	--min_alt 26 --min_ratio 2.35	random	18	18	17	16	69
Pypolca	--min_alt 4 --min_ratio 4.54	mutated	12	5	0	0	17
Pypolca	--min_alt 14 --min_ratio 2.24	random	18	17	10	9	54
Pypolca	--min_alt 4 --min_ratio 4.52	mutated	12	5	0	0	17
Pypolca	--min_alt 5 --min_ratio 0.62	random	13	6	2	2	23
Pypolca	--min_alt 17 --min_ratio 17.14	random	18	17	11	9	55
Pypolca	--min_alt 10 --min_ratio 3.65	random	17	13	7	6	43
Pypolca	--min_alt 16 --min_ratio 13.41	random	18	17	11	9	55
Pypolca	--min_alt 3 --min_ratio 26.55	random	11	3	3	1	18
Pypolca	--min_alt 22 --min_ratio 23.07	random	18	18	15	15	66
Pypolca	--min_alt 20 --min_ratio 18.62	random	18	18	15	12	63
Pypolca	--min_alt 3 --min_ratio 23.44	random	11	3	3	1	18
Pypolca	--min_alt 3 --min_ratio 4.43	mutated	11	3	0	0	14
Pypolca	--min_alt 13 --min_ratio 5.25	random	17	16	10	9	52
Pypolca	--min_alt 15 --min_ratio 10.48	random	18	17	11	9	55
Pypolca	--min_alt 4 --min_ratio 4.34	mutated	12	5	0	0	17
Pypolca	--min_alt 25 --min_ratio 6.12	random	18	18	17	16	69
Pypolca	--min_alt 5 --min_ratio 24.67	random	13	6	3	1	23
Pypolca	--min_alt 3 --min_ratio 12.2	random	11	3	3	1	18
Pypolca	--min_alt 2 --min_ratio 4.38	mutated	13	3	0	0	16
Pypolca	--min_alt 25 --min_ratio 1.71	random	18	18	17	16	69
Pypolca	--min_alt 4 --min_ratio 4.44	mutated	12	5	0	0	17
Pypolca	--min_alt 3 --min_ratio 12.76	random	11	3	3	1	18
Pypolca	--min_alt 3 --min_ratio 4.39	mutated	11	3	0	0	14
Pypolca	--min_alt 14 --min_ratio 0.83	random	18	17	10	9	54
Pypolca	--min_alt 2 --min_ratio 4.39	mutated	13	3	0	0	16
Pypolca	--min_alt 11 --min_ratio 19.09	random	17	13	8	6	44
Pypolca	--min_alt 3 --min_ratio 4.41	mutated	11	3	0	0	14
Pypolca	--min_alt 19 --min_ratio 2.04	random	18	18	13	11	60
Pypolca	--min_alt 2 --min_ratio 1.28	random	54	8	2	0	64
Pypolca	--min_alt 2 --min_ratio 2.62	random	14	3	0	0	17
Pypolca	--min_alt 4 --min_ratio 4.41	mutated	12	5	0	0	17
Pypolca	--min_alt 2 --min_ratio 13.57	random	13	3	3	1	20
Pypolca	--min_alt 19 --min_ratio 26.23	random	18	18	13	11	60
Pypolca	--min_alt 3 --min_ratio 4.37	mutated	11	3	0	0	14
Pypolca	--min_alt 4 --min_ratio 14.09	random	12	5	3	1	21
Pypolca	--min_alt 17 --min_ratio 2.58	random	18	17	11	9	55
Pypolca	--min_alt 3 --min_ratio 4.32	mutated	11	3	0	0	14
Pypolca	--min_alt 6 --min_ratio 14.07	random	17	8	3	1	29
Pypolca	--min_alt 24 --min_ratio 3.01	random	18	18	16	15	67
Pypolca	--min_alt 6 --min_ratio 2.63	random	17	8	0	1	26
Pypolca	--min_alt 5 --min_ratio 4.37	random	13	6	0	0	19
Pypolca	--min_alt 8 --min_ratio 11.55	random	17	10	6	4	37
Pypolca	--min_alt 4 --min_ratio 4.39	mutated	12	5	0	0	17
Pypolca	--min_alt 4 --min_ratio 8.53	random	12	5	3	1	21
Pypolca	--min_alt 19 --min_ratio 14.0	random	18	18	13	11	60
Pypolca	--min_alt 4 --min_ratio 4.32	mutated	12	5	0	0	17
Pypolca	--min_alt 26 --min_ratio 3.2	random	18	18	17	16	69
Pypolca	--min_alt 3 --min_ratio 4.23	mutated	11	3	0	0	14
Pypolca	--min_alt 1 --min_ratio 14.4	random	13	3	3	1	20
Pypolca	--min_alt 2 --min_ratio 4.19	mutated	13	3	0	0	16
Pypolca	--min_alt 7 --min_ratio 3.27	random	17	10	3	4	34
Pypolca	--min_alt 3 --min_ratio 4.2	mutated	11	3	0	0	14
Pypolca	--min_alt 22 --min_ratio 5.79	random	18	18	15	15	66
Pypolca	--min_alt 2 --min_ratio 4.14	mutated	13	3	0	0	16
Pypolca	--min_alt 7 --min_ratio 10.21	random	17	10	6	4	37
Pypolca	--min_alt 3 --min_ratio 4.19	mutated	11	3	0	0	14
Pypolca	--min_alt 18 --min_ratio 9.13	random	18	18	12	10	58
Pypolca	--min_alt 17 --min_ratio 11.26	random	18	17	11	9	55
Pypolca	--min_alt 2 --min_ratio 19.04	random	13	3	3	1	20
Pypolca	--min_alt 2 --min_ratio 4.15	mutated	13	3	0	0	16
Pypolca	--min_alt 25 --min_ratio 7.63	random	18	18	17	16	69
Pypolca	--min_alt 3 --min_ratio 4.21	mutated	11	3	0	0	14
Pypolca	--min_alt 1 --min_ratio 2.01	random	14	3	0	0	17
Pypolca	--min_alt 8 --min_ratio 0.85	random	17	10	6	4	37
Pypolca	--min_alt 6 --min_ratio 3.12	random	17	8	0	1	26
Pypolca	--min_alt 3 --min_ratio 4.16	mutated	11	3	0	0	14
Pypolca	--min_alt 16 --min_ratio 1.0	random	18	17	11	9	55
Pypolca	--min_alt 3 --min_ratio 4.08	mutated	11	3	0	0	14
Pypolca	--min_alt 4 --min_ratio 6.44	random	12	5	0	1	18
Pypolca	--min_alt 4 --min_ratio 4.08	mutated	12	5	0	0	17
Pypolca	--min_alt 17 --min_ratio 2.19	random	18	17	11	9	55
Pypolca	--min_alt 17 --min_ratio 1.09	random	18	17	11	9	55
Pypolca	--min_alt 2 --min_ratio 4.08	mutated	13	3	0	0	16
Pypolca	--min_alt 12 --min_ratio 15.06	random	17	15	10	8	50
Pypolca	--min_alt 10 --min_ratio 14.3	random	17	13	7	6	43
Pypolca	--min_alt 8 --min_ratio 1.17	random	17	10	6	4	37
Pypolca	--min_alt 3 --min_ratio 4.17	mutated	11	3	0	0	14
Pypolca	--min_alt 12 --min_ratio 24.25	random	17	15	10	8	50
Pypolca	--min_alt 3 --min_ratio 4.26	mutated	11	3	0	0	14
Pypolca	--min_alt 2 --min_ratio 2.51	random	14	3	0	0	17
Pypolca	--min_alt 3 --min_ratio 4.18	mutated	11	3	0	0	14
Pypolca	--min_alt 20 --min_ratio 2.44	random	18	18	15	12	63
Pypolca	--min_alt 2 --min_ratio 4.18	mutated	13	3	0	0	16
Pypolca	--min_alt 16 --min_ratio 5.47	random	18	17	11	9	55
Pypolca	--min_alt 4 --min_ratio 4.18	mutated	12	5	0	0	17
Pypolca	--min_alt 18 --min_ratio 20.34	random	18	18	12	10	58
Pypolca	--min_alt 20 --min_ratio 2.01	random	18	18	15	12	63
Pypolca	--min_alt 3 --min_ratio 4.1	mutated	11	3	0	0	14
Pypolca	--min_alt 5 --min_ratio 20.8	random	13	6	3	1	23
Pypolca	--min_alt 13 --min_ratio 16.96	random	17	16	10	9	52
Pypolca	--min_alt 3 --min_ratio 4.09	mutated	11	3	0	0	14
Pypolca	--min_alt 1 --min_ratio 1.22	random	54	8	2	0	64
Pypolca	--min_alt 3 --min_ratio 17.26	random	11	3	3	1	18
Pypolca	--min_alt 2 --min_ratio 4.09	mutated	13	3	0	0	16
Pypolca	--min_alt 3 --min_ratio 2.24	random	12	3	0	0	15
Pypolca	--min_alt 2 --min_ratio 4.12	mutated	13	3	0	0	16
Pypolca	--min_alt 4 --min_ratio 1.06	random	12	5	0	0	17
Pypolca	--min_alt 3 --min_ratio 1.41	random	13	3	0	0	16
Pypolca	--min_alt 9 --min_ratio 4.97	random	17	10	7	5	39
Pypolca	--min_alt 3 --min_ratio 3.99	mutated	11	3	0	0	14
Pypolca	--min_alt 4 --min_ratio 0.8	random	12	5	0	1	18
Pypolca	--min_alt 3 --min_ratio 3.89	mutated	11	3	0	0	14
Pypolca	--min_alt 10 --min_ratio 2.5	random	17	13	7	6	43
Pypolca	--min_alt 10 --min_ratio 14.26	random	17	13	7	6	43
Pypolca	--min_alt 4 --min_ratio 3.89	mutated	12	5	0	0	17
Pypolca	--min_alt 4 --min_ratio 8.94	random	12	5	3	1	21
Pypolca	--min_alt 7 --min_ratio 1.09	random	17	10	3	4	34
Pypolca	--min_alt 4 --min_ratio 3.92	mutated	12	5	0	0	17
Pypolca	--min_alt 25 --min_ratio 11.42	random	18	18	17	16	69
Pypolca	--min_alt 2 --min_ratio 1.34	random	54	8	2	0	64
Pypolca	--min_alt 2 --min_ratio 3.89	mutated	13	3	0	0	16
Pypolca	--min_alt 1 --min_ratio 18.1	random	13	3	3	1	20
Pypolca	--min_alt 19 --min_ratio 5.47	random	18	18	13	11	60
Pypolca	--min_alt 3 --min_ratio 2.09	random	12	3	0	0	15
Pypolca	--min_alt 4 --min_ratio 3.82	mutated	12	5	0	0	17
Pypolca	--min_alt 3 --min_ratio 3.85	random	11	3	0	0	14
Pypolca	--min_alt 2 --min_ratio 3.76	mutated	13	3	0	0	16
Pypolca	--min_alt 11 --min_ratio 9.82	random	17	13	8	6	44
Pypolca	--min_alt 2 --min_ratio 3.87	mutated	13	3	0	0	16
Pypolca	--min_alt 21 --min_ratio 1.6	random	18	18	15	13	64
Pypolca	--min_alt 2 --min_ratio 3.85	mutated	13	3	0	0	16
Pypolca	--min_alt 2 --min_ratio 7.77	random	13	3	3	1	20
Pypolca	--min_alt 18 --min_ratio 20.28	random	18	18	12	10	58
Pypolca	--min_alt 4 --min_ratio 3.85	mutated	12	5	0	0	17
Pypolca	--min_alt 26 --min_ratio 13.72	random	18	18	17	16	69
Pypolca	--min_alt 13 --min_ratio 10.82	random	17	16	10	9	52
Pypolca	--min_alt 2 --min_ratio 3.93	mutated	13	3	0	0	16
Pypolca	--min_alt 1 --min_ratio 7.14	random	13	3	3	1	20
Pypolca	--min_alt 18 --min_ratio 2.03	random	18	18	12	10	58
Pypolca	--min_alt 12 --min_ratio 12.9	random	17	15	10	8	50
Pypolca	--min_alt 7 --min_ratio 4.73	random	17	10	3	4	34
Pypolca	--min_alt 6 --min_ratio 24.28	random	17	8	3	1	29
Pypolca	--min_alt 13 --min_ratio 1.07	random	17	16	10	9	52
Pypolca	--min_alt 4 --min_ratio 0.72	random	12	5	1	1	19
Pypolca	--min_alt 3 --min_ratio 3.8	mutated	11	3	0	0	14
Pypolca	--min_alt 9 --min_ratio 10.52	random	17	10	7	5	39
Pypolca	--min_alt 4 --min_ratio 3.8	mutated	12	5	0	0	17
Pypolca	--min_alt 25 --min_ratio 2.49	random	18	18	17	16	69
Pypolca	--min_alt 9 --min_ratio 1.12	random	17	10	7	5	39
Pypolca	--min_alt 7 --min_ratio 7.36	random	17	10	6	4	37
Pypolca	--min_alt 2 --min_ratio 5.3	random	13	3	0	1	17
Pypolca	--min_alt 25 --min_ratio 1.27	random	18	18	17	16	69
Pypolca	--min_alt 2 --min_ratio 3.8	mutated	13	3	0	0	16
Pypolca	--min_alt 12 --min_ratio 20.45	random	17	15	10	8	50
Pypolca	--min_alt 4 --min_ratio 3.86	mutated	12	5	0	0	17
Pypolca	--min_alt 2 --min_ratio 7.27	random	13	3	3	1	20
Pypolca	--min_alt 5 --min_ratio 21.68	random	13	6	3	1	23
Pypolca	--min_alt 2 --min_ratio 3.71	mutated	13	3	0	0	16
Pypolca	--min_alt 2 --min_ratio 3.31	random	13	3	0	0	16
Pypolca	--min_alt 15 --min_ratio 9.85	random	18	17	11	9	55
Pypolca	--min_alt 13 --min_ratio 0.55	random	17	16	10	9	52
Pypolca	--min_alt 11 --min_ratio 4.06	random	17	13	8	6	44
Pypolca	--min_alt 2 --min_ratio 3.77	mutated	13	3	0	0	16
Pypolca	--min_alt 10 --min_ratio 14.46	random	17	13	7	6	43
Pypolca	--min_alt 5 --min_ratio 0.83	random	13	6	0	1	20
Pypolca	--min_alt 17 --min_ratio 11.77	random	18	17	11	9	55
Pypolca	--min_alt 15 --min_ratio 10.37	random	18	17	11	9	55
Pypolca	--min_alt 1 --min_ratio 11.44	random	13	3	3	1	20
Pypolca	--min_alt 3 --min_ratio 3.75	mutated	11	3	0	0	14
Pypolca	--min_alt 20 --min_ratio 4.08	random	18	18	15	12	63
Pypolca	--min_alt 20 --min_ratio 24.4	random	18	18	15	12	63
Pypolca	--min_alt 3 --min_ratio 3.72	mutated	11	3	0	0	14
Pypolca	--min_alt 3 --min_ratio 2.46	random	12	3	0	0	15
Pypolca	--min_alt 2 --min_ratio 5.95	random	13	3	0	1	17
Pypolca	--min_alt 20 --min_ratio 26.79	random	18	18	15	12	63
Pypolca	--min_alt 1 --min_ratio 20.54	random	13	3	3	1	20
Pypolca	--min_alt 25 --min_ratio 25.9	random	18	18	17	16	69
Pypolca	--min_alt 3 --min_ratio 3.78	mutated	11	3	0	0	14
Pypolca	--min_alt 1 --min_ratio 1.25	random	54	8	2	0	64
Pypolca	--min_alt 3 --min_ratio 3.71	mutated	11	3	0	0	14
Pypolca	--min_alt 7 --min_ratio 3.28	random	17	10	3	4	34
Pypolca	--min_alt 3 --min_ratio 3.73	mutated	11	3	0	0	14
Pypolca	--min_alt 7 --min_ratio 5.49	random	17	10	3	4	34
Pypolca	--min_alt 3 --min_ratio 3.65	mutated	11	3	0	0	14
Pypolca	--min_alt 2 --min_ratio 3.36	random	13	3	0	0	16
Pypolca	--min_alt 4 --min_ratio 3.65	mutated	12	5	0	0	17
Pypolca	--min_alt 6 --min_ratio 1.1	random	17	8	0	1	26
Pypolca	--min_alt 1 --min_ratio 1.52	random	53	8	2	0	63
Pypolca	--min_alt 11 --min_ratio 7.2	random	17	13	8	6	44
Pypolca	--min_alt 2 --min_ratio 3.69	mutated	13	3	0	0	16
Pypolca	--min_alt 1 --min_ratio 14.75	random	13	3	3	1	20
Pypolca	--min_alt 26 --min_ratio 12.6	random	18	18	17	16	69
Pypolca	--min_alt 3 --min_ratio 9.92	random	11	3	3	1	18
Pypolca	--min_alt 3 --min_ratio 3.66	mutated	11	3	0	0	14
Pypolca	--min_alt 18 --min_ratio 5.92	random	18	18	12	10	58
Pypolca	--min_alt 3 --min_ratio 3.69	mutated	11	3	0	0	14
Pypolca	--min_alt 4 --min_ratio 2.42	random	12	5	0	0	17
Pypolca	--min_alt 4 --min_ratio 3.69	mutated	12	5	0	0	17
Pypolca	--min_alt 2 --min_ratio 16.97	random	13	3	3	1	20
Pypolca	--min_alt 2 --min_ratio 3.79	mutated	13	3	0	0	16
Pypolca	--min_alt 9 --min_ratio 6.53	random	17	10	7	5	39
Pypolca	--min_alt 10 --min_ratio 25.22	random	17	13	7	6	43
Pypolca	--min_alt 11 --min_ratio 22.35	random	17	13	8	6	44
Pypolca	--min_alt 3 --min_ratio 3.62	mutated	11	3	0	0	14
Pypolca	--min_alt 10 --min_ratio 17.43	random	17	13	7	6	43
Pypolca	--min_alt 3 --min_ratio 3.54	mutated	11	3	0	0	14
Pypolca	--min_alt 17 --min_ratio 12.72	random	18	17	11	9	55
Pypolca	--min_alt 3 --min_ratio 0.83	random	16	3	1	1	21
Pypolca	--min_alt 4 --min_ratio 3.56	mutated	12	5	0	0	17
Pypolca	--min_alt 7 --min_ratio 1.65	random	17	10	3	4	34
Pypolca	--min_alt 16 --min_ratio 15.26	random	18	17	11	9	55
Pypolca	--min_alt 2 --min_ratio 3.54	mutated	13	3	0	0	16
Pypolca	--min_alt 6 --min_ratio 3.35	random	17	8	0	1	26
Pypolca	--min_alt 3 --min_ratio 3.45	mutated	11	3	0	0	14
Pypolca	--min_alt 20 --min_ratio 6.72	random	18	18	15	12	63
Pypolca	--min_alt 2 --min_ratio 3.5	mutated	13	3	0	0	16
Pypolca	--min_alt 19 --min_ratio 5.06	random	18	18	13	11	60
Pypolca	--min_alt 3 --min_ratio 3.39	mutated	11	3	0	0	14
Pypolca	--min_alt 8 --min_ratio 8.7	random	17	10	6	4	37
Pypolca	--min_alt 4 --min_ratio 3.34	mutated	12	5	0	0	17
Pypolca	--min_alt 20 --min_ratio 16.24	random	18	18	15	12	63
Pypolca	--min_alt 2 --min_ratio 3.39	mutated	13	3	0	0	16
Pypolca	--min_alt 15 --min_ratio 1.01	random	18	17	11	9	55
Pypolca	--min_alt 4 --min_ratio 3.39	mutated	12	5	0	0	17
Pypolca	--min_alt 6 --min_ratio 1.9	random	17	8	0	1	26
Pypolca	--min_alt 5 --min_ratio 9.52	random	13	6	3	1	23
Pypolca	--min_alt 3 --min_ratio 3.41	mutated	11	3	0	0	14
Pypolca	--min_alt 9 --min_ratio 1.84	random	17	10	7	5	39
Pypolca	--min_alt 3 --min_ratio 3.43	mutated	11	3	0	0	14
Pypolca	--min_alt 20 --min_ratio 17.99	random	18	18	15	12	63
Pypolca	--min_alt 27 --min_ratio 16.72	random	18	18	17	17	70
Pypolca	--min_alt 14 --min_ratio 9.13	random	18	17	10	9	54
Pypolca	--min_alt 2 --min_ratio 3.46	mutated	13	3	0	0	16
Pypolca	--min_alt 13 --min_ratio 19.93	random	17	16	10	9	52
Pypolca	--min_alt 3 --min_ratio 3.4	mutated	11	3	0	0	14
Pypolca	--min_alt 15 --min_ratio 14.32	random	18	17	11	9	55
Pypolca	--min_alt 4 --min_ratio 3.43	mutated	12	5	0	0	17
Pypolca	--min_alt 12 --min_ratio 12.14	random	17	15	10	8	50
Pypolca	--min_alt 2 --min_ratio 3.4	mutated	13	3	0	0	16
Pypolca	--min_alt 12 --min_ratio 13.49	random	17	15	10	8	50
Pypolca	--min_alt 14 --min_ratio 4.53	random	18	17	10	9	54
Pypolca	--min_alt 9 --min_ratio 12.16	random	17	10	7	5	39
Pypolca	--min_alt 21 --min_ratio 2.15	random	18	18	15	13	64
Pypolca	--min_alt 3 --min_ratio 3.3	mutated	11	3	0	0	14
Pypolca	--min_alt 14 --min_ratio 15.81	random	18	17	10	9	54
Pypolca	--min_alt 16 --min_ratio 2.3	random	18	17	11	9	55
Pypolca	--min_alt 3 --min_ratio 3.29	mutated	11	3	0	0	14
Pypolca	--min_alt 8 --min_ratio 17.11	random	17	10	6	4	37
Pypolca	--min_alt 22 --min_ratio 0.7	random	18	18	15	15	66
Pypolca	--min_alt 2 --min_ratio 3.29	mutated	13	3	0	0	16
Pypolca	--min_alt 9 --min_ratio 6.55	random	17	10	7	5	39
Pypolca	--min_alt 3 --min_ratio 3.28	mutated	11	3	0	0	14
Pypolca	--min_alt 3 --min_ratio 2.06	random	12	3	0	0	15
Pypolca	--min_alt 12 --min_ratio 3.69	random	17	15	10	8	50
Pypolca	--min_alt 2 --min_ratio 3.28	mutated	13	3	0	0	16
Pypolca	--min_alt 25 --min_ratio 11.34	random	18	18	17	16	69
Pypolca	--min_alt 3 --min_ratio 3.34	mutated	11	3	0	0	14
Pypolca	--min_alt 22 --min_ratio 2.74	random	18	18	15	15	66
Pypolca	--min_alt 3 --min_ratio 5.86	random	11	3	0	1	15
Pypolca	--min_alt 2 --min_ratio 3.34	mutated	13	3	0	0	16
Pypolca	--min_alt 15 --min_ratio 15.5	random	18	17	11	9	55
Pypolca	--min_alt 2 --min_ratio 3.27	mutated	13	3	0	0	16
Pypolca	--min_alt 1 --min_ratio 4.89	random	13	3	0	0	16
Pypolca	--min_alt 5 --min_ratio 9.67	random	13	6	3	1	23
Pypolca	--min_alt 4 --min_ratio 3.36	mutated	12	5	0	0	17
Pypolca	--min_alt 19 --min_ratio 0.72	random	18	18	13	11	60
Pypolca	--min_alt 17 --min_ratio 12.85	random	18	17	11	9	55
Pypolca	--min_alt 8 --min_ratio 16.08	random	17	10	6	4	37
Pypolca	--min_alt 17 --min_ratio 5.75	random	18	17	11	9	55
Pypolca	--min_alt 15 --min_ratio 7.6	random	18	17	11	9	55
Pypolca	--min_alt 8 --min_ratio 14.75	random	17	10	6	4	37
Pypolca	--min_alt 3 --min_ratio 0.96	random	16	3	1	1	21
Pypolca	--min_alt 2 --min_ratio 20.69	random	13	3	3	1	20
Pypolca	--min_alt 4 --min_ratio 3.28	mutated	12	5	0	0	17
Pypolca	--min_alt 16 --min_ratio 1.18	random	18	17	11	9	55
Pypolca	--min_alt 4 --min_ratio 24.77	random	12	5	3	1	21
Pypolca	--min_alt 10 --min_ratio 1.48	random	17	13	7	6	43
Pypolca	--min_alt 2 --min_ratio 17.62	random	13	3	3	1	20
Pypolca	--min_alt 21 --min_ratio 5.83	random	18	18	15	13	64
Pypolca	--min_alt 7 --min_ratio 1.94	random	17	10	3	4	34
Pypolca	--min_alt 3 --min_ratio 3.37	mutated	11	3	0	0	14
Pypolca	--min_alt 2 --min_ratio 8.94	random	13	3	3	1	20
Pypolca	--min_alt 2 --min_ratio 3.37	mutated	13	3	0	0	16
Pypolca	--min_alt 15 --min_ratio 21.94	random	18	17	11	9	55
Pypolca	--min_alt 4 --min_ratio 3.32	mutated	12	5	0	0	17
Pypolca	--min_alt 18 --min_ratio 2.96	random	18	18	12	10	58
Pypolca	--min_alt 7 --min_ratio 14.35	random	17	10	6	4	37
Pypolca	--min_alt 4 --min_ratio 3.37	mutated	12	5	0	0	17
Pypolca	--min_alt 11 --min_ratio 13.81	random	17	13	8	6	44
Pypolca	--min_alt 2 --min_ratio 26.77	random	13	3	3	1	20
Pypolca	--min_alt 2 --min_ratio 3.45	mutated	13	3	0	0	16
Pypolca	--min_alt 2 --min_ratio 0.52	random	186	68	21	5	280
Pypolca	--min_alt 7 --min_ratio 0.75	random	17	10	3	4	34
Pypolca	--min_alt 4 --min_ratio 3.42	mutated	12	5	0	0	17
Pypolca	--min_alt 22 --min_ratio 0.73	random	18	18	15	15	66
Pypolca	--min_alt 20 --min_ratio 5.51	random	18	18	15	12	63
Pypolca	--min_alt 4 --min_ratio 3.45	mutated	12	5	0	0	17
Pypolca	--min_alt 27 --min_ratio 20.82	random	18	18	17	17	70
Pypolca	--min_alt 8 --min_ratio 10.06	random	17	10	6	4	37
Pypolca	--min_alt 3 --min_ratio 3.44	mutated	11	3	0	0	14
Pypolca	--min_alt 13 --min_ratio 8.61	random	17	16	10	9	52
Pypolca	--min_alt 1 --min_ratio 17.14	random	13	3	3	1	20
Pypolca	--min_alt 4 --min_ratio 3.44	mutated	12	5	0	0	17
Pypolca	--min_alt 3 --min_ratio 5.69	random	11	3	0	1	15
Pypolca	--min_alt 3 --min_ratio 3.47	mutated	11	3	0	0	14
Pypolca	--min_alt 7 --min_ratio 0.77	random	17	10	3	4	34
Pypolca	--min_alt 4 --min_ratio 3.4	mutated	12	5	0	0	17
Pypolca	--min_alt 5 --min_ratio 19.63	random	13	6	3	1	23
Pypolca	--min_alt 3 --min_ratio 3.42	mutated	11	3	0	0	14
Pypolca	--min_alt 8 --min_ratio 10.16	random	17	10	6	4	37
Pypolca	--min_alt 2 --min_ratio 3.32	mutated	13	3	0	0	16
Pypolca	--min_alt 4 --min_ratio 0.83	random	12	5	0	1	18
Pypolca	--min_alt 3 --min_ratio 6.98	random	11	3	0	1	15
Pypolca	--min_alt 3 --min_ratio 7.52	random	11	3	3	1	18
Pypolca	--min_alt 1 --min_ratio 3.4	random	13	3	0	0	16
Pypolca	--min_alt 12 --min_ratio 19.75	random	17	15	10	8	50
Pypolca	--min_alt 1 --min_ratio 5.17	random	13	3	0	1	17
Pypolca	--min_alt 2 --min_ratio 3.42	mutated	13	3	0	0	16
Pypolca	--min_alt 10 --min_ratio 24.77	random	17	13	7	6	43
Pypolca	--min_alt 6 --min_ratio 11.84	random	17	8	3	1	29
Pypolca	--min_alt 18 --min_ratio 8.36	random	18	18	12	10	58
Pypolca	--min_alt 4 --min_ratio 3.33	mutated	12	5	0	0	17
Pypolca	--min_alt 23 --min_ratio 3.22	random	18	18	15	15	66
Pypolca	--min_alt 21 --min_ratio 9.85	random	18	18	15	13	64
Pypolca	--min_alt 7 --min_ratio 1.32	random	17	10	3	4	34
Pypolca	--min_alt 2 --min_ratio 3.41	mutated	13	3	0	0	16
Pypolca	--min_alt 3 --min_ratio 9.31	random	11	3	3	1	18
Pypolca	--min_alt 2 --min_ratio 3.47	mutated	13	3	0	0	16
Pypolca	--min_alt 3 --min_ratio 11.6	random	11	3	3	1	18
Pypolca	--min_alt 18 --min_ratio 1.16	random	18	18	12	10	58
Pypolca	--min_alt 11 --min_ratio 7.78	random	17	13	8	6	44
Pypolca	--min_alt 2 --min_ratio 4.24	random	13	3	0	0	16
Pypolca	--min_alt 4 --min_ratio 3.5	mutated	12	5	0	0	17
Pypolca	--min_alt 2 --min_ratio 1.51	random	53	8	2	0	63
Pypolca	--min_alt 3 --min_ratio 3.33	mutated	11	3	0	0	14
Pypolca	--min_alt 20 --min_ratio 4.43	random	18	18	15	12	63
Pypolca	--min_alt 24 --min_ratio 6.86	random	18	18	16	15	67
Pypolca	--min_alt 15 --min_ratio 1.46	random	18	17	11	9	55
Pypolca	--min_alt 3 --min_ratio 3.26	mutated	11	3	0	0	14
Pypolca	--min_alt 9 --min_ratio 3.06	random	17	10	7	5	39
Pypolca	--min_alt 2 --min_ratio 3.26	mutated	13	3	0	0	16
Pypolca	--min_alt 18 --min_ratio 0.53	random	18	18	12	10	58
Pypolca	--min_alt 4 --min_ratio 3.26	mutated	12	5	0	0	17
Pypolca	--min_alt 21 --min_ratio 4.75	random	18	18	15	13	64
Pypolca	--min_alt 5 --min_ratio 1.21	random	13	6	0	0	19
Pypolca	--min_alt 2 --min_ratio 20.29	random	13	3	3	1	20
Pypolca	--min_alt 3 --min_ratio 3.22	mutated	11	3	0	0	14
Pypolca	--min_alt 7 --min_ratio 21.29	random	17	10	6	4	37
Pypolca	--min_alt 2 --min_ratio 3.22	mutated	13	3	0	0	16
Pypolca	--min_alt 11 --min_ratio 12.16	random	17	13	8	6	44
Pypolca	--min_alt 3 --min_ratio 3.13	mutated	11	3	0	0	14
Pypolca	--min_alt 14 --min_ratio 25.3	random	18	17	10	9	54
Pypolca	--min_alt 21 --min_ratio 16.24	random	18	18	15	13	64
Pypolca	--min_alt 4 --min_ratio 3.13	mutated	12	5	0	0	17
Pypolca	--min_alt 19 --min_ratio 1.74	random	18	18	13	11	60
Pypolca	--min_alt 2 --min_ratio 3.12	mutated	13	3	0	0	16
Pypolca	--min_alt 8 --min_ratio 8.54	random	17	10	6	4	37
Pypolca	--min_alt 2 --min_ratio 3.14	mutated	13	3	0	0	16
Pypolca	--min_alt 3 --min_ratio 20.77	random	11	3	3	1	18
Pypolca	--min_alt 21 --min_ratio 6.25	random	18	18	15	13	64
Pypolca	--min_alt 3 --min_ratio 3.19	mutated	11	3	0	0	14
Pypolca	--min_alt 7 --min_ratio 13.89	random	17	10	6	4	37
Pypolca	--min_alt 4 --min_ratio 0.7	random	12	5	2	2	21
Pypolca	--min_alt 3 --min_ratio 3.1	mutated	11	3	0	0	14
Pypolca	--min_alt 14 --min_ratio 5.4	random	18	17	10	9	54
Pypolca	--min_alt 2 --min_ratio 3.1	mutated	13	3	0	0	16
Pypolca	--min_alt 4 --min_ratio 1.38	random	12	5	0	0	17
Pypolca	--min_alt 1 --min_ratio 0.52	random	186	68	21	5	280
Pypolca	--min_alt 4 --min_ratio 3.1	mutated	12	5	0	0	17
Pypolca	--min_alt 26 --min_ratio 2.14	random	18	18	17	16	69
Pypolca	--min_alt 3 --min_ratio 7.28	random	11	3	3	1	18
Pypolca	--min_alt 19 --min_ratio 22.07	random	18	18	13	11	60
Pypolca	--min_alt 1 --min_ratio 2.25	random	14	3	0	0	17
Pypolca	--min_alt 25 --min_ratio 1.5	random	18	18	17	16	69
Pypolca	--min_alt 6 --min_ratio 10.28	random	17	8	3	1	29
Pypolca	--min_alt 4 --min_ratio 3.06	mutated	12	5	0	0	17
Pypolca	--min_alt 2 --min_ratio 2.16	random	14	3	0	0	17
Pypolca	--min_alt 20 --min_ratio 22.06	random	18	18	15	12	63
Pypolca	--min_alt 3 --min_ratio 3.06	mutated	11	3	0	0	14
Pypolca	--min_alt 1 --min_ratio 0.9	random	118	18	5	1	142
Pypolca	--min_alt 12 --min_ratio 3.89	random	17	15	10	8	50
Pypolca	--min_alt 2 --min_ratio 12.76	random	13	3	3	1	20
Pypolca	--min_alt 2 --min_ratio 3.06	mutated	13	3	0	0	16
Pypolca	--min_alt 26 --min_ratio 22.97	random	18	18	17	16	69
Pypolca	--min_alt 4 --min_ratio 3.05	mutated	12	5	0	0	17
Pypolca	--min_alt 25 --min_ratio 1.05	random	18	18	17	16	69
Pypolca	--min_alt 4 --min_ratio 3.07	mutated	12	5	0	0	17
Pypolca	--min_alt 5 --min_ratio 10.89	random	13	6	3	1	23
Pypolca	--min_alt 3 --min_ratio 3.01	mutated	11	3	0	0	14
Pypolca	--min_alt 4 --min_ratio 2.98	mutated	12	5	0	0	17
Pypolca	--min_alt 4 --min_ratio 7.63	random	12	5	3	1	21
Pypolca	--min_alt 22 --min_ratio 3.68	random	18	18	15	15	66
Pypolca	--min_alt 22 --min_ratio 8.11	random	18	18	15	15	66
Pypolca	--min_alt 2 --min_ratio 3.01	mutated	13	3	0	0	16
Pypolca	--min_alt 26 --min_ratio 6.91	random	18	18	17	16	69
Pypolca	--min_alt 4 --min_ratio 3.01	mutated	12	5	0	0	17
Pypolca	--min_alt 14 --min_ratio 13.02	random	18	17	10	9	54
Pypolca	--min_alt 13 --min_ratio 1.22	random	17	16	10	9	52
Pypolca	--min_alt 20 --min_ratio 16.03	random	18	18	15	12	63
Pypolca	--min_alt 2 --min_ratio 17.33	random	13	3	3	1	20
Pypolca	--min_alt 16 --min_ratio 6.51	random	18	17	11	9	55
Pypolca	--min_alt 3 --min_ratio 3.03	mutated	11	3	0	0	14
Pypolca	--min_alt 1 --min_ratio 1.38	random	54	8	2	0	64
Pypolca	--min_alt 3 --min_ratio 3.11	mutated	11	3	0	0	14
Pypolca	--min_alt 26 --min_ratio 23.13	random	18	18	17	16	69
Pypolca	--min_alt 3 --min_ratio 3.05	mutated	11	3	0	0	14
Pypolca	--min_alt 1 --min_ratio 21.05	random	13	3	3	1	20
Pypolca	--min_alt 6 --min_ratio 1.5	random	17	8	0	1	26
Pypolca	--min_alt 2 --min_ratio 2.96	mutated	14	3	0	0	17
Pypolca	--min_alt 25 --min_ratio 8.76	random	18	18	17	16	69
Pypolca	--min_alt 2 --min_ratio 3.05	mutated	13	3	0	0	16
Pypolca	--min_alt 19 --min_ratio 16.27	random	18	18	13	11	60
Pypolca	--min_alt 21 --min_ratio 18.51	random	18	18	15	13	64
Pypolca	--min_alt 2 --min_ratio 12.58	random	13	3	3	1	20
Pypolca	--min_alt 7 --min_ratio 5.67	random	17	10	3	4	34
Pypolca	--min_alt 6 --min_ratio 11.79	random	17	8	3	1	29
Pypolca	--min_alt 2 --min_ratio 3.0	mutated	14	3	0	0	17
Pypolca	--min_alt 2 --min_ratio 17.18	random	13	3	3	1	20
Pypolca	--min_alt 25 --min_ratio 15.22	random	18	18	17	16	69
Pypolca	--min_alt 9 --min_ratio 18.75	random	17	10	7	5	39
Pypolca	--min_alt 4 --min_ratio 3.09	mutated	12	5	0	0	17
Pypolca	--min_alt 22 --min_ratio 14.68	random	18	18	15	15	66
Pypolca	--min_alt 3 --min_ratio 2.97	mutated	12	3	0	0	15
Pypolca	--min_alt 24 --min_ratio 1.03	random	18	18	16	15	67
Pypolca	--min_alt 3 --min_ratio 3.0	mutated	12	3	0	0	15
Pypolca	--min_alt 15 --min_ratio 5.01	random	18	17	11	9	55
Pypolca	--min_alt 6 --min_ratio 1.17	random	17	8	0	1	26
Pypolca	--min_alt 2 --min_ratio 2.99	mutated	14	3	0	0	17
Pypolca	--min_alt 10 --min_ratio 7.62	random	17	13	7	6	43
Pypolca	--min_alt 1 --min_ratio 1.89	random	53	8	2	0	63
Pypolca	--min_alt 4 --min_ratio 3.04	mutated	12	5	0	0	17
Pypolca	--min_alt 6 --min_ratio 5.63	random	17	8	0	1	26
Pypolca	--min_alt 16 --min_ratio 7.93	random	18	17	11	9	55
Pypolca	--min_alt 22 --min_ratio 6.38	random	18	18	15	15	66
Pypolca	--min_alt 23 --min_ratio 0.87	random	18	18	15	15	66
Pypolca	--min_alt 4 --min_ratio 1.4	random	12	5	0	0	17
Pypolca	--min_alt 3 --min_ratio 3.04	mutated	11	3	0	0	14
Pypolca	--min_alt 6 --min_ratio 1.81	random	17	8	0	1	26
Pypolca	--min_alt 24 --min_ratio 1.17	random	18	18	16	15	67
Pypolca	--min_alt 6 --min_ratio 9.81	random	17	8	3	1	29
Pypolca	--min_alt 3 --min_ratio 3.12	mutated	11	3	0	0	14
Pypolca	--min_alt 13 --min_ratio 6.08	random	17	16	10	9	52
Pypolca	--min_alt 3 --min_ratio 3.02	mutated	11	3	0	0	14
Pypolca	--min_alt 1 --min_ratio 3.63	random	13	3	0	0	16
Pypolca	--min_alt 2 --min_ratio 3.07	mutated	13	3	0	0	16
Pypolca	--min_alt 8 --min_ratio 5.55	random	17	10	6	4	37
Pypolca	--min_alt 3 --min_ratio 2.99	mutated	12	3	0	0	15
Pypolca	--min_alt 22 --min_ratio 24.65	random	18	18	15	15	66
Pypolca	--min_alt 4 --min_ratio 2.95	mutated	12	5	0	0	17
Pypolca	--min_alt 6 --min_ratio 9.43	random	17	8	3	1	29
Pypolca	--min_alt 2 --min_ratio 3.02	mutated	13	3	0	0	16
Pypolca	--min_alt 6 --min_ratio 1.06	random	17	8	0	1	26
Pypolca	--min_alt 3 --min_ratio 3.08	mutated	11	3	0	0	14
Pypolca	--min_alt 24 --min_ratio 23.73	random	18	18	16	15	67
Pypolca	--min_alt 13 --min_ratio 1.75	random	17	16	10	9	52
Pypolca	--min_alt 2 --min_ratio 3.08	mutated	13	3	0	0	16
Pypolca	--min_alt 4 --min_ratio 16.33	random	12	5	3	1	21
Pypolca	--min_alt 26 --min_ratio 25.41	random	18	18	17	16	69
Pypolca	--min_alt 4 --min_ratio 3.16	mutated	12	5	0	0	17
Pypolca	--min_alt 1 --min_ratio 1.17	random	54	8	2	0	64
Pypolca	--min_alt 4 --min_ratio 4.59	random	12	5	0	0	17
Pypolca	--min_alt 1 --min_ratio 21.04	random	13	3	3	1	20
Pypolca	--min_alt 3 --min_ratio 24.24	random	11	3	3	1	18
Pypolca	--min_alt 5 --min_ratio 9.82	random	13	6	3	1	23
Pypolca	--min_alt 22 --min_ratio 1.34	random	18	18	15	15	66
Pypolca	--min_alt 3 --min_ratio 13.49	random	11	3	3	1	18
Pypolca	--min_alt 14 --min_ratio 15.62	random	18	17	10	9	54
Pypolca	--min_alt 8 --min_ratio 5.04	random	17	10	6	4	37
Pypolca	--min_alt 9 --min_ratio 12.82	random	17	10	7	5	39
Pypolca	--min_alt 4 --min_ratio 3.15	mutated	12	5	0	0	17
Pypolca	--min_alt 12 --min_ratio 14.35	random	17	15	10	8	50
Pypolca	--min_alt 24 --min_ratio 11.31	random	18	18	16	15	67
Pypolca	--min_alt 17 --min_ratio 3.28	random	18	17	11	9	55
Pypolca	--min_alt 4 --min_ratio 3.08	mutated	12	5	0	0	17
Pypolca	--min_alt 2 --min_ratio 0.79	random	118	18	5	1	142
Pypolca	--min_alt 19 --min_ratio 16.16	random	18	18	13	11	60
Pypolca	--min_alt 2 --min_ratio 3.09	mutated	13	3	0	0	16
Pypolca	--min_alt 6 --min_ratio 1.66	random	17	8	0	1	26
Pypolca	--min_alt 4 --min_ratio 11.16	random	12	5	3	1	21
Pypolca	--min_alt 8 --min_ratio 12.95	random	17	10	6	4	37
Pypolca	--min_alt 11 --min_ratio 1.84	random	17	13	8	6	44
Pypolca	--min_alt 2 --min_ratio 6.92	random	13	3	0	1	17
Pypolca	--min_alt 8 --min_ratio 18.61	random	17	10	6	4	37
Pypolca	--min_alt 3 --min_ratio 3.17	mutated	11	3	0	0	14
Pypolca	--min_alt 4 --min_ratio 1.85	random	12	5	0	0	17
Pypolca	--min_alt 2 --min_ratio 3.17	mutated	13	3	0	0	16
Pypolca	--min_alt 2 --min_ratio 5.44	random	13	3	0	1	17
Pypolca	--min_alt 5 --min_ratio 3.88	random	13	6	0	0	19
Pypolca	--min_alt 3 --min_ratio 3.58	random	11	3	0	0	14
Pypolca	--min_alt 4 --min_ratio 3.58	mutated	12	5	0	0	17
Pypolca	--min_alt 13 --min_ratio 9.45	random	17	16	10	9	52
Pypolca	--min_alt 2 --min_ratio 3.58	mutated	13	3	0	0	16
Pypolca	--min_alt 23 --min_ratio 5.15	random	18	18	15	15	66
Pypolca	--min_alt 3 --min_ratio 6.25	random	11	3	0	1	15
Pypolca	--min_alt 15 --min_ratio 5.81	random	18	17	11	9	55
Pypolca	--min_alt 8 --min_ratio 12.01	random	17	10	6	4	37
Pypolca	--min_alt 12 --min_ratio 11.0	random	17	15	10	8	50
Pypolca	--min_alt 1 --min_ratio 10.06	random	13	3	3	1	20
Pypolca	--min_alt 3 --min_ratio 3.57	mutated	11	3	0	0	14
Pypolca	--min_alt 2 --min_ratio 2.03	random	14	3	0	0	17
Pypolca	--min_alt 24 --min_ratio 24.21	random	18	18	16	15	67
Pypolca	--min_alt 4 --min_ratio 3.62	mutated	12	5	0	0	17
Pypolca	--min_alt 15 --min_ratio 12.32	random	18	17	11	9	55
Pypolca	--min_alt 2 --min_ratio 21.45	random	13	3	3	1	20
Pypolca	--min_alt 2 --min_ratio 3.57	mutated	13	3	0	0	16
Pypolca	--min_alt 25 --min_ratio 26.48	random	18	18	17	16	69
Pypolca	--min_alt 6 --min_ratio 17.73	random	17	8	3	1	29
Pypolca	--min_alt 4 --min_ratio 3.54	mutated	12	5	0	0	17
Pypolca	--min_alt 5 --min_ratio 4.18	random	13	6	0	0	19
Pypolca	--min_alt 6 --min_ratio 1.42	random	17	8	0	1	26
Pypolca	--min_alt 3 --min_ratio 3.52	mutated	11	3	0	0	14
Pypolca	--min_alt 6 --min_ratio 14.73	random	17	8	3	1	29
Pypolca	--min_alt 2 --min_ratio 3.52	mutated	13	3	0	0	16
Pypolca	--min_alt 27 --min_ratio 1.83	random	18	18	17	17	70
Pypolca	--min_alt 5 --min_ratio 17.84	random	13	6	3	1	23
Pypolca	--min_alt 7 --min_ratio 2.41	random	17	10	3	4	34
Pypolca	--min_alt 1 --min_ratio 26.41	random	13	3	3	1	20
Pypolca	--min_alt 3 --min_ratio 3.56	mutated	11	3	0	0	14
Pypolca	--min_alt 5 --min_ratio 17.29	random	13	6	3	1	23
Pypolca	--min_alt 2 --min_ratio 3.56	mutated	13	3	0	0	16
Pypolca	--min_alt 3 --min_ratio 26.74	random	11	3	3	1	18
Pypolca	--min_alt 26 --min_ratio 7.93	random	18	18	17	16	69
Pypolca	--min_alt 17 --min_ratio 23.4	random	18	17	11	9	55
Pypolca	--min_alt 4 --min_ratio 3.57	mutated	12	5	0	0	17
Pypolca	--min_alt 6 --min_ratio 6.25	random	17	8	0	1	26
Pypolca	--min_alt 13 --min_ratio 11.57	random	17	16	10	9	52
Pypolca	--min_alt 2 --min_ratio 0.51	random	186	68	21	5	280
Pypolca	--min_alt 3 --min_ratio 3.61	mutated	11	3	0	0	14
Pypolca	--min_alt 1 --min_ratio 2.23	random	14	3	0	0	17
Pypolca	--min_alt 2 --min_ratio 0.74	random	118	22	7	1	148
Pypolca	--min_alt 14 --min_ratio 22.54	random	18	17	10	9	54
Pypolca	--min_alt 8 --min_ratio 2.79	random	17	10	6	4	37
Pypolca	--min_alt 2 --min_ratio 3.61	mutated	13	3	0	0	16
Pypolca	--min_alt 6 --min_ratio 6.24	random	17	8	0	1	26
Pypolca	--min_alt 2 --min_ratio 1.39	random	54	8	2	0	64
Pypolca	--min_alt 3 --min_ratio 1.26	random	13	3	0	0	16
Pypolca	--min_alt 3 --min_ratio 1.06	random	13	3	0	0	16
Pypolca	--min_alt 3 --min_ratio 3.59	mutated	11	3	0	0	14
Pypolca	--min_alt 8 --min_ratio 8.93	random	17	10	6	4	37
Pypolca	--min_alt 14 --min_ratio 18.91	random	18	17	10	9	54
Pypolca	--min_alt 3 --min_ratio 3.53	mutated	11	3	0	0	14
Pypolca	--min_alt 6 --min_ratio 17.52	random	17	8	3	1	29
Pypolca	--min_alt 4 --min_ratio 3.59	mutated	12	5	0	0	17
Pypolca	--min_alt 16 --min_ratio 22.14	random	18	17	11	9	55
Pypolca	--min_alt 12 --min_ratio 9.95	random	17	15	10	8	50
Pypolca	--min_alt 2 --min_ratio 3.53	mutated	13	3	0	0	16
Pypolca	--min_alt 2 --min_ratio 5.08	random	13	3	0	1	17
Pypolca	--min_alt 21 --min_ratio 23.54	random	18	18	15	13	64
Pypolca	--min_alt 19 --min_ratio 11.96	random	18	18	13	11	60
Pypolca	--min_alt 2 --min_ratio 10.57	random	13	3	3	1	20
Pypolca	--min_alt 19 --min_ratio 4.31	random	18	18	13	11	60
Pypolca	--min_alt 5 --min_ratio 4.34	random	13	6	0	0	19
Pypolca	--min_alt 27 --min_ratio 21.96	random	18	18	17	17	70
Pypolca	--min_alt 4 --min_ratio 3.53	mutated	12	5	0	0	17
Pypolca	--min_alt 11 --min_ratio 18.32	random	17	13	8	6	44
Pypolca	--min_alt 8 --min_ratio 3.89	random	17	10	6	4	37
Pypolca	--min_alt 3 --min_ratio 3.46	mutated	11	3	0	0	14
Pypolca	--min_alt 4 --min_ratio 9.91	random	12	5	3	1	21
Pypolca	--min_alt 4 --min_ratio 3.46	mutated	12	5	0	0	17
Pypolca	--min_alt 23 --min_ratio 15.4	random	18	18	15	15	66
Pypolca	--min_alt 21 --min_ratio 17.59	random	18	18	15	13	64
Pypolca	--min_alt 4 --min_ratio 3.48	mutated	12	5	0	0	17
Pypolca	--min_alt 4 --min_ratio 3.49	random	12	5	0	0	17
Pypolca	--min_alt 3 --min_ratio 3.49	mutated	11	3	0	0	14
Pypolca	--min_alt 4 --min_ratio 3.51	mutated	12	5	0	0	17
Pypolca	--min_alt 2 --min_ratio 6.24	random	13	3	0	1	17
Pypolca	--min_alt 6 --min_ratio 9.98	random	17	8	3	1	29
Pypolca	--min_alt 1 --min_ratio 7.74	random	13	3	3	1	20
Pypolca	--min_alt 23 --min_ratio 10.52	random	18	18	15	15	66
Pypolca	--min_alt 2 --min_ratio 14.16	random	13	3	3	1	20
Pypolca	--min_alt 3 --min_ratio 8.22	random	11	3	3	1	18
Pypolca	--min_alt 2 --min_ratio 3.49	mutated	13	3	0	0	16
Pypolca	--min_alt 17 --min_ratio 4.78	random	18	17	11	9	55
Pypolca	--min_alt 4 --min_ratio 7.99	random	12	5	3	1	21
Pypolca	--min_alt 3 --min_ratio 3.51	mutated	11	3	0	0	14
Pypolca	--min_alt 3 --min_ratio 26.45	random	11	3	3	1	18
Pypolca	--min_alt 4 --min_ratio 13.36	random	12	5	3	1	21
Pypolca	--min_alt 9 --min_ratio 23.23	random	17	10	7	5	39
Pypolca	--min_alt 2 --min_ratio 3.51	mutated	13	3	0	0	16
Pypolca	--min_alt 12 --min_ratio 0.75	random	17	15	10	8	50
Pypolca	--min_alt 18 --min_ratio 14.5	random	18	18	12	10	58
Pypolca	--min_alt 22 --min_ratio 6.24	random	18	18	15	15	66
Pypolca	--min_alt 10 --min_ratio 0.57	random	17	13	7	6	43
Pypolca	--min_alt 18 --min_ratio 1.47	random	18	18	12	10	58
Pypolca	--min_alt 17 --min_ratio 21.12	random	18	17	11	9	55
Pypolca	--min_alt 26 --min_ratio 0.6	random	18	18	17	16	69
Pypolca	--min_alt 2 --min_ratio 10.86	random	13	3	3	1	20
Pypolca	--min_alt 5 --min_ratio 13.57	random	13	6	3	1	23
Pypolca	--min_alt 14 --min_ratio 18.08	random	18	17	10	9	54
Pypolca	--min_alt 9 --min_ratio 1.66	random	17	10	7	5	39
Pypolca	--min_alt 23 --min_ratio 5.64	random	18	18	15	15	66
Pypolca	--min_alt 4 --min_ratio 3.52	mutated	12	5	0	0	17
Pypolca	--min_alt 2 --min_ratio 8.59	random	13	3	3	1	20
Pypolca	--min_alt 11 --min_ratio 5.76	random	17	13	8	6	44
Pypolca	--min_alt 3 --min_ratio 1.61	random	12	3	0	0	15
Pypolca	--min_alt 18 --min_ratio 10.73	random	18	18	12	10	58
Pypolca	--min_alt 3 --min_ratio 6.11	random	11	3	0	1	15
Pypolca	--min_alt 10 --min_ratio 19.38	random	17	13	7	6	43
Pypolca	--min_alt 8 --min_ratio 1.59	random	17	10	6	4	37
Pypolca	--min_alt 2 --min_ratio 24.6	random	13	3	3	1	20
Pypolca	--min_alt 1 --min_ratio 0.79	random	118	18	5	1	142
Pypolca	--min_alt 19 --min_ratio 12.22	random	18	18	13	11	60
Pypolca	--min_alt 4 --min_ratio 4.79	random	12	5	0	0	17
Pypolca	--min_alt 2 --min_ratio 3.59	mutated	13	3	0	0	16
Pypolca	--min_alt 2 --min_ratio 6.48	random	13	3	0	1	17
Pypolca	--min_alt 7 --min_ratio 8.67	random	17	10	6	4	37
Pypolca	--min_alt 8 --min_ratio 6.11	random	17	10	6	4	37
Pypolca	--min_alt 1 --min_ratio 7.71	random	13	3	3	1	20
Pypolca	--min_alt 3 --min_ratio 16.69	random	11	3	3	1	18
Pypolca	--min_alt 12 --min_ratio 1.34	random	17	15	10	8	50
Pypolca	--min_alt 18 --min_ratio 20.4	random	18	18	12	10	58
Pypolca	--min_alt 2 --min_ratio 6.2	random	13	3	0	1	17
Pypolca	--min_alt 6 --min_ratio 19.2	random	17	8	3	1	29
Pypolca	--min_alt 3 --min_ratio 3.5	mutated	11	3	0	0	14
Pypolca	--min_alt 12 --min_ratio 1.04	random	17	15	10	8	50
Pypolca	--min_alt 2 --min_ratio 18.04	random	13	3	3	1	20
Pypolca	--min_alt 15 --min_ratio 4.34	random	18	17	11	9	55
Pypolca	--min_alt 19 --min_ratio 0.61	random	18	18	13	11	60
Pypolca	--min_alt 21 --min_ratio 3.18	random	18	18	15	13	64
Pypolca	--min_alt 4 --min_ratio 4.38	random	12	5	0	0	17
Pypolca	--min_alt 6 --min_ratio 1.25	random	17	8	0	1	26
Pypolca	--min_alt 26 --min_ratio 4.48	random	18	18	17	16	69
Pypolca	--min_alt 2 --min_ratio 1.74	random	53	8	2	0	63
Pypolca	--min_alt 3 --min_ratio 13.42	random	11	3	3	1	18
Pypolca	--min_alt 9 --min_ratio 1.55	random	17	10	7	5	39
Pypolca	--min_alt 4 --min_ratio 1.34	random	12	5	0	0	17
Pypolca	--min_alt 1 --min_ratio 16.38	random	13	3	3	1	20
Pypolca	--min_alt 3 --min_ratio 0.78	random	16	3	1	1	21
Pypolca	--min_alt 21 --min_ratio 2.95	random	18	18	15	13	64
Pypolca	--min_alt 13 --min_ratio 26.08	random	17	16	10	9	52
Pypolca	--min_alt 4 --min_ratio 3.41	mutated	12	5	0	0	17
Pypolca	--min_alt 24 --min_ratio 1.23	random	18	18	16	15	67
Pypolca	--min_alt 22 --min_ratio 1.77	random	18	18	15	15	66
Pypolca	--min_alt 9 --min_ratio 0.53	random	17	10	7	5	39
Pypolca	--min_alt 10 --min_ratio 3.3	random	17	13	7	6	43
Pypolca	--min_alt 1 --min_ratio 0.93	random	118	18	5	1	142
Pypolca	--min_alt 22 --min_ratio 3.52	random	18	18	15	15	66
Pypolca	--min_alt 25 --min_ratio 18.22	random	18	18	17	16	69
Pypolca	--min_alt 10 --min_ratio 3.55	random	17	13	7	6	43
Pypolca	--min_alt 7 --min_ratio 2.78	random	17	10	3	4	34
Pypolca	--min_alt 10 --min_ratio 0.92	random	17	13	7	6	43
Pypolca	--min_alt 2 --min_ratio 4.62	random	13	3	0	0	16
Pypolca	--min_alt 9 --min_ratio 0.72	random	17	10	7	5	39
Pypolca	--min_alt 24 --min_ratio 6.82	random	18	18	16	15	67
Pypolca	--min_alt 5 --min_ratio 3.26	random	13	6	0	0	19
Pypolca	--min_alt 1 --min_ratio 24.9	random	13	3	3	1	20
Pypolca	--min_alt 23 --min_ratio 4.37	random	18	18	15	15	66
Pypolca	--min_alt 12 --min_ratio 10.16	random	17	15	10	8	50
Pypolca	--min_alt 1 --min_ratio 3.37	random	13	3	0	0	16
Pypolca	--min_alt 2 --min_ratio 7.16	random	13	3	3	1	20
Pypolca	--min_alt 1 --min_ratio 26.24	random	13	3	3	1	20
Pypolca	--min_alt 17 --min_ratio 20.01	random	18	17	11	9	55
Pypolca	--min_alt 15 --min_ratio 9.14	random	18	17	11	9	55
Pypolca	--min_alt 15 --min_ratio 1.26	random	18	17	11	9	55
Pypolca	--min_alt 6 --min_ratio 15.9	random	17	8	3	1	29
Pypolca	--min_alt 18 --min_ratio 1.84	random	18	18	12	10	58
Pypolca	--min_alt 11 --min_ratio 7.63	random	17	13	8	6	44
Pypolca	--min_alt 18 --min_ratio 0.81	random	18	18	12	10	58
Pypolca	--min_alt 2 --min_ratio 10.38	random	13	3	3	1	20
Pypolca	--min_alt 7 --min_ratio 7.89	random	17	10	6	4	37
Pypolca	--min_alt 14 --min_ratio 1.15	random	18	17	10	9	54
Pypolca	--min_alt 10 --min_ratio 8.1	random	17	13	7	6	43
Pypolca	--min_alt 14 --min_ratio 19.94	random	18	17	10	9	54
Pypolca	--min_alt 15 --min_ratio 1.43	random	18	17	11	9	55
Pypolca	--min_alt 19 --min_ratio 18.7	random	18	18	13	11	60
Pypolca	--min_alt 5 --min_ratio 1.74	random	13	6	0	0	19
Pypolca	--min_alt 1 --min_ratio 26.35	random	13	3	3	1	20
Pypolca	--min_alt 20 --min_ratio 7.7	random	18	18	15	12	63
Pypolca	--min_alt 22 --min_ratio 15.68	random	18	18	15	15	66
Pypolca	--min_alt 17 --min_ratio 5.24	random	18	17	11	9	55
Pypolca	--min_alt 21 --min_ratio 4.17	random	18	18	15	13	64
Pypolca	--min_alt 2 --min_ratio 7.3	random	13	3	3	1	20
Pypolca	--min_alt 5 --min_ratio 26.9	random	13	6	3	1	23
Pypolca	--min_alt 11 --min_ratio 17.29	random	17	13	8	6	44
Pypolca	--min_alt 3 --min_ratio 16.62	random	11	3	3	1	18
Pypolca	--min_alt 3 --min_ratio 16.57	random	11	3	3	1	18
Pypolca	--min_alt 5 --min_ratio 8.78	random	13	6	3	1	23
Pypolca	--min_alt 11 --min_ratio 17.13	random	17	13	8	6	44
Pypolca	--min_alt 13 --min_ratio 3.31	random	17	16	10	9	52
Pypolca	--min_alt 3 --min_ratio 2.73	random	12	3	0	0	15
Pypolca	--min_alt 1 --min_ratio 17.99	random	13	3	3	1	20
Pypolca	--min_alt 9 --min_ratio 0.86	random	17	10	7	5	39
Pypolca	--min_alt 2 --min_ratio 3.48	mutated	13	3	0	0	16
Pypolca	--min_alt 12 --min_ratio 18.21	random	17	15	10	8	50
Pypolca	--min_alt 12 --min_ratio 23.22	random	17	15	10	8	50
Pypolca	--min_alt 7 --min_ratio 2.71	random	17	10	3	4	34
Pypolca	--min_alt 7 --min_ratio 19.69	random	17	10	6	4	37
Pypolca	--min_alt 5 --min_ratio 1.93	random	13	6	0	0	19
Pypolca	--min_alt 22 --min_ratio 4.44	random	18	18	15	15	66
Pypolca	--min_alt 1 --min_ratio 5.72	random	13	3	0	1	17
Pypolca	--min_alt 4 --min_ratio 4.81	random	12	5	0	0	17
Pypolca	--min_alt 3 --min_ratio 3.48	mutated	11	3	0	0	14
Pypolca	--min_alt 3 --min_ratio 5.72	random	11	3	0	1	15
Pypolca	--min_alt 4 --min_ratio 19.88	random	12	5	3	1	21
Pypolca	--min_alt 3 --min_ratio 3.38	mutated	11	3	0	0	14
Pypolca	--min_alt 4 --min_ratio 5.35	random	12	5	0	1	18
Pypolca	--min_alt 19 --min_ratio 1.51	random	18	18	13	11	60
Pypolca	--min_alt 4 --min_ratio 3.38	mutated	12	5	0	0	17
Pypolca	--min_alt 2 --min_ratio 3.68	random	13	3	0	0	16
Pypolca	--min_alt 5 --min_ratio 7.18	random	13	6	3	1	23
Pypolca	--min_alt 6 --min_ratio 8.24	random	17	8	3	1	29
Pypolca	--min_alt 2 --min_ratio 3.67	random	13	3	0	0	16
Pypolca	--min_alt 10 --min_ratio 1.91	random	17	13	7	6	43
Pypolca	--min_alt 19 --min_ratio 22.64	random	18	18	13	11	60
Pypolca	--min_alt 4 --min_ratio 2.3	random	12	5	0	0	17
Pypolca	--min_alt 2 --min_ratio 3.35	mutated	13	3	0	0	16
Pypolca	--min_alt 12 --min_ratio 25.54	random	17	15	10	8	50
Pypolca	--min_alt 15 --min_ratio 26.92	random	18	17	11	9	55
Pypolca	--min_alt 21 --min_ratio 1.21	random	18	18	15	13	64
Pypolca	--min_alt 1 --min_ratio 10.52	random	13	3	3	1	20
Pypolca	--min_alt 13 --min_ratio 19.27	random	17	16	10	9	52
Pypolca	--min_alt 7 --min_ratio 4.79	random	17	10	3	4	34
Pypolca	--min_alt 2 --min_ratio 3.43	mutated	13	3	0	0	16
Pypolca	--min_alt 2 --min_ratio 0.81	random	118	18	5	1	142
Pypolca	--min_alt 26 --min_ratio 11.82	random	18	18	17	16	69
Pypolca	--min_alt 1 --min_ratio 0.66	random	183	58	20	3	264
Pypolca	--min_alt 3 --min_ratio 3.32	mutated	11	3	0	0	14
Pypolca	--min_alt 14 --min_ratio 1.46	random	18	17	10	9	54
Pypolca	--min_alt 8 --min_ratio 21.53	random	17	10	6	4	37
Pypolca	--min_alt 3 --min_ratio 15.07	random	11	3	3	1	18
Pypolca	--min_alt 3 --min_ratio 17.98	random	11	3	3	1	18
Pypolca	--min_alt 3 --min_ratio 12.91	random	11	3	3	1	18
Pypolca	--min_alt 7 --min_ratio 2.36	random	17	10	3	4	34
Pypolca	--min_alt 11 --min_ratio 1.35	random	17	13	8	6	44
Pypolca	--min_alt 4 --min_ratio 1.32	random	12	5	0	0	17
Pypolca	--min_alt 11 --min_ratio 19.3	random	17	13	8	6	44
Pypolca	--min_alt 5 --min_ratio 4.6	random	13	6	0	0	19
Pypolca	--min_alt 2 --min_ratio 1.22	random	54	8	2	0	64
Pypolca	--min_alt 7 --min_ratio 9.27	random	17	10	6	4	37
Pypolca	--min_alt 3 --min_ratio 3.36	mutated	11	3	0	0	14
Pypolca	--min_alt 10 --min_ratio 10.34	random	17	13	7	6	43
Pypolca	--min_alt 3 --min_ratio 9.61	random	11	3	3	1	18
Pypolca	--min_alt 11 --min_ratio 16.73	random	17	13	8	6	44
Pypolca	--min_alt 16 --min_ratio 1.06	random	18	17	11	9	55
Pypolca	--min_alt 9 --min_ratio 10.35	random	17	10	7	5	39
Pypolca	--min_alt 14 --min_ratio 1.2	random	18	17	10	9	54
Pypolca	--min_alt 19 --min_ratio 9.48	random	18	18	13	11	60
Pypolca	--min_alt 3 --min_ratio 11.47	random	11	3	3	1	18
Pypolca	--min_alt 14 --min_ratio 4.52	random	18	17	10	9	54
Pypolca	--min_alt 15 --min_ratio 8.98	random	18	17	11	9	55
Pypolca	--min_alt 2 --min_ratio 1.67	random	53	8	2	0	63
Pypolca	--min_alt 2 --min_ratio 3.38	mutated	13	3	0	0	16
Pypolca	--min_alt 20 --min_ratio 9.89	random	18	18	15	12	63
Pypolca	--min_alt 25 --min_ratio 5.05	random	18	18	17	16	69
Pypolca	--min_alt 27 --min_ratio 9.0	random	18	18	17	17	70
Pypolca	--min_alt 6 --min_ratio 4.12	random	17	8	0	1	26
Pypolca	--min_alt 13 --min_ratio 3.98	random	17	16	10	9	52
Pypolca	--min_alt 8 --min_ratio 11.54	random	17	10	6	4	37
Pypolca	--min_alt 6 --min_ratio 3.82	random	17	8	0	1	26
Pypolca	--min_alt 23 --min_ratio 15.7	random	18	18	15	15	66
Pypolca	--min_alt 26 --min_ratio 13.01	random	18	18	17	16	69
Pypolca	--min_alt 8 --min_ratio 0.79	random	17	10	6	4	37
Pypolca	--min_alt 13 --min_ratio 0.61	random	17	16	10	9	52
Pypolca	--min_alt 2 --min_ratio 18.14	random	13	3	3	1	20
Pypolca	--min_alt 1 --min_ratio 12.62	random	13	3	3	1	20
Pypolca	--min_alt 4 --min_ratio 1.24	random	12	5	0	0	17
Pypolca	--min_alt 15 --min_ratio 21.89	random	18	17	11	9	55
Pypolca	--min_alt 8 --min_ratio 0.72	random	17	10	6	4	37
Pypolca	--min_alt 20 --min_ratio 2.64	random	18	18	15	12	63
Pypolca	--min_alt 4 --min_ratio 1.78	random	12	5	0	0	17
Pypolca	--min_alt 10 --min_ratio 19.32	random	17	13	7	6	43
Pypolca	--min_alt 5 --min_ratio 2.55	random	13	6	0	0	19
Pypolca	--min_alt 2 --min_ratio 0.86	random	118	18	5	1	142
Pypolca	--min_alt 3 --min_ratio 8.41	random	11	3	3	1	18
Pypolca	--min_alt 13 --min_ratio 16.51	random	17	16	10	9	52
Pypolca	--min_alt 4 --min_ratio 3.35	mutated	12	5	0	0	17
Pypolca	--min_alt 26 --min_ratio 13.13	random	18	18	17	16	69
Pypolca	--min_alt 23 --min_ratio 8.59	random	18	18	15	15	66
Pypolca	--min_alt 4 --min_ratio 2.24	random	12	5	0	0	17
Pypolca	--min_alt 25 --min_ratio 13.29	random	18	18	17	16	69
Pypolca	--min_alt 12 --min_ratio 14.14	random	17	15	10	8	50
Pypolca	--min_alt 14 --min_ratio 13.35	random	18	17	10	9	54
Pypolca	--min_alt 4 --min_ratio 18.38	random	12	5	3	1	21
Pypolca	--min_alt 8 --min_ratio 7.91	random	17	10	6	4	37
Pypolca	--min_alt 10 --min_ratio 24.39	random	17	13	7	6	43
Pypolca	--min_alt 6 --min_ratio 12.56	random	17	8	3	1	29
Pypolca	--min_alt 2 --min_ratio 12.95	random	13	3	3	1	20
Pypolca	--min_alt 15 --min_ratio 3.07	random	18	17	11	9	55
Pypolca	--min_alt 23 --min_ratio 3.43	random	18	18	15	15	66
Pypolca	--min_alt 4 --min_ratio 12.59	random	12	5	3	1	21
Pypolca	--min_alt 12 --min_ratio 2.85	random	17	15	10	8	50
Pypolca	--min_alt 15 --min_ratio 22.34	random	18	17	11	9	55
Pypolca	--min_alt 5 --min_ratio 11.13	random	13	6	3	1	23
Pypolca	--min_alt 3 --min_ratio 3.27	mutated	11	3	0	0	14
Pypolca	--min_alt 13 --min_ratio 1.42	random	17	16	10	9	52
Pypolca	--min_alt 10 --min_ratio 6.73	random	17	13	7	6	43
Pypolca	--min_alt 7 --min_ratio 16.65	random	17	10	6	4	37
Pypolca	--min_alt 4 --min_ratio 3.27	mutated	12	5	0	0	17
Pypolca	--min_alt 1 --min_ratio 22.56	random	13	3	3	1	20
Pypolca	--min_alt 11 --min_ratio 2.2	random	17	13	8	6	44
Pypolca	--min_alt 12 --min_ratio 4.07	random	17	15	10	8	50
Pypolca	--min_alt 5 --min_ratio 22.09	random	13	6	3	1	23
Pypolca	--min_alt 14 --min_ratio 21.4	random	18	17	10	9	54
Pypolca	--min_alt 2 --min_ratio 19.19	random	13	3	3	1	20
Pypolca	--min_alt 23 --min_ratio 17.54	random	18	18	15	15	66
Pypolca	--min_alt 16 --min_ratio 0.82	random	18	17	11	9	55
Pypolca	--min_alt 22 --min_ratio 1.55	random	18	18	15	15	66
Pypolca	--min_alt 9 --min_ratio 1.24	random	17	10	7	5	39
Pypolca	--min_alt 1 --min_ratio 9.75	random	13	3	3	1	20
Pypolca	--min_alt 11 --min_ratio 6.74	random	17	13	8	6	44
Pypolca	--min_alt 6 --min_ratio 19.26	random	17	8	3	1	29
Pypolca	--min_alt 11 --min_ratio 3.39	random	17	13	8	6	44
Pypolca	--min_alt 14 --min_ratio 2.09	random	18	17	10	9	54
Pypolca	--min_alt 4 --min_ratio 3.29	mutated	12	5	0	0	17
Pypolca	--min_alt 23 --min_ratio 1.0	random	18	18	15	15	66
Pypolca	--min_alt 3 --min_ratio 3.64	random	11	3	0	0	14
Pypolca	--min_alt 2 --min_ratio 3.7	mutated	13	3	0	0	16
Pypolca	--min_alt 11 --min_ratio 19.29	random	17	13	8	6	44
Pypolca	--min_alt 16 --min_ratio 2.82	random	18	17	11	9	55
Pypolca	--min_alt 3 --min_ratio 3.7	mutated	11	3	0	0	14
Pypolca	--min_alt 4 --min_ratio 18.89	random	12	5	3	1	21
Pypolca	--min_alt 2 --min_ratio 3.62	mutated	13	3	0	0	16
Pypolca	--min_alt 11 --min_ratio 9.85	random	17	13	8	6	44
